挨	ái	next to
癌症	áizhèng	cancer
爱不释手	àibúshìshǒu	so much that one cannot bear to part with it
爱戴	àidài	love and esteem
暧昧	àimèi	ambiguous
安宁	ānníng	peaceful; calm
安详	ānxiáng	serene; composed
安置	ānzhì	put; arrange for
暗示	ànshì	suggest secretly
案件	ànjiàn	law case; case
案例	ànlì	case
按摩	ànmó	massage
昂贵	ángguì	expensive
凹凸	āotū	concave-convex
熬	áo	boil
奥秘	àomì	secret
扒	bā	hold on to; dig up; push aside;
疤	bā	scar
巴不得	bābude	eagerly look forward to
巴结	bājié	stutter
拔苗助长	bámiáozhùzhǎng	spoil things by excessive enthusiasm
把关	bǎguān	hold the pass
把手	bǎshou	knob
霸道	bàdào	overbearing
罢工	bàgōng	strike
掰	bāi	break off with fingers and thumb
摆脱	bǎituō	cast off
拜访	bàifǎng	visit
拜年	bàinián	congratulate the new year
拜托	bàituō	request
败坏	bàihuài	corrupt
斑	bān	speckle
颁布	bānbù	promulgate; issue
颁发	bānfā	award; issue
版本	bǎnběn	edition
半途而废	bàntú'érfèi	give up halfway
伴侣	bànlǚ	partner; mate
伴随	bànsuí	go with
扮演	bànyǎn	play the role
绑架	bǎngjià	kidnap
榜样	bǎngyàng	example
磅	bàng	pound
包庇	bāobì	shield
包袱	bāofu	burden
包围	bāowéi	surround
包装	bāozhuāng	pack; put up; make up
饱和	bǎohé	saturated
饱经沧桑	bǎojīngcāngsāng	have seen much of the changes in human life
保管	bǎoguǎn	safekeeping
保密	bǎomì	secrecy
保姆	bǎomǔ	nurse; mammy
保守	bǎoshǒu	conservative
保卫	bǎowèi	defend
保养	bǎoyǎng	maintain
保障	bǎozhàng	guarantee
保重	bǎozhòng	take care of oneself
抱负	bàofù	ambition
报仇	bàochóu	revenge
报酬	bàochou	remuneration
报答	bàodá	reciprocate; pay back; repay
报复	bàofù	payback
报警	bàojǐng	call the police
报销	bàoxiāo	submit and expense account
爆发	bàofā	burst
爆炸	bàozhà	blast
曝光	bàoguāng	exposure
暴力	bàolì	violence
暴露	bàolù	expose
悲哀	bēi'āi	grief
悲惨	bēicǎn	miserable
卑鄙	bēibǐ	despicable
北极	běijí	arctic
被动	bèidòng	passive
被告	bèigào	defendant
背叛	bèipàn	sellout; betray
背诵	bèisòng	recite
备份	bèifèn	backups
备忘录	bèiwànglù	memorandum
贝壳	bèikè	shell; conch
奔波	bēnbō	rush about
奔驰	bēnchí	run quickly
本能	běnnéng	instinct
本钱	běnqián	capital
本人	běnrén	oneself
本身	běnshēn	itself
本事	běnshi	skill
笨拙	bènzhuō	clumsy
崩溃	bēngkuì	collapse breakdown
甭	béng	not
蹦	bèng	jump
迸发	bèngfā	burst
逼迫	bīpò	force; compel
鼻涕	bítì	nasal mucus
比方	bǐfāng	example
比喻	bǐyù	comparison; trope
比重	bǐzhòng	specific gravity; proportion
鄙视	bǐshì	despise
臂	bì	arm
弊病	bìbìng	ills
弊端	bìduān	malpractice
闭塞	bìsè	occlusion
鞭策	biāncè	urge on
编织	biānzhī	weave
边疆	biānjiāng	frontier
边界	biānjiè	boundary
边境	biānjìng	border; frontier
边缘	biānyuán	edge
扁	biǎn	flat
贬低	biǎndī	depreciate
贬义	biǎnyì	derogatory sense
遍布	biànbù	all over
便利	biànlì	facilitate
便条	biàntiáo	note
便于	biànyú	easy to
变故	biàngù	misfortune
变迁	biànqiān	changes
变质	biànzhì	deteriorate
辩护	biànhù	defend
辩解	biànjiě	explain
辩证	biànzhèng	dialectical
辨认	biànrèn	distinguish
辫子	biànzi	queue; plait
标本	biāoběn	specimen; demo
标记	biāojì	sign
标题	biāotí	title; heading
表决	biǎojué	vote
表态	biǎotài	clarify one's position
表彰	biǎozhāng	commend; cite
憋	biē	hold back
别墅	biéshù	villa
别致	biézhì	unique
别扭	bièniu	unnatural; awkward
濒临	bīnlín	on the verge of
冰雹	bīngbáo	hail
丙	bǐng	third of the ten Heavenly Stems
并非	bìngfēi	not so
并列	bìngliè	parallel
拨	bō	dial
播种	bōzhòng	sow
波浪	bōlàng	wave
波涛	bōtāo	waves
剥削	bōxuē	exploitation
博大精深	bódàjīngshēn	broad and profound
博览会	bólǎnhuì	exposition
搏斗	bódòu	struggle; fight
伯母	bómǔ	aunt
薄弱	bóruò	weak
不顾	búgù	disregard
不愧	búkuì	worthy
不料	búliào	unexpectedly
不像话	búxiànghuà	unreasonable
不屑一顾	búxièyígù	a contemptuous disregard
补偿	bǔcháng	compensate
补救	bǔjiù	remedy
补贴	bǔtiē	subsidy
哺乳	bǔrǔ	lactation
捕捉	bǔzhuō	catch
不得已	bùdéyǐ	have no alternative but to
不妨	bùfáng	might as well
不敢当	bùgǎndāng	I really don't deserve this
不禁	bùjīn	can not help but
不堪	bùkān	can't bear
不可思议	bùkěsīyì	it is beyond logic and above reason
不免	bùmiǎn	unavoidable
不时	bùshí	now and then
不惜	bùxī	not spare; not hesitate
不相上下	bùxiāngshàngxià	about the same; equally matched
不言而喻	bùyán'éryù	self-evident
不由得	bùyóude	cannot help
不择手段	bùzéshǒuduàn	use unscrupulous divisive tactics
不止	bùzhǐ	more than
布告	bùgào	notice
布局	bùjú	distribution; layout
布置	bùzhì	arrangement
步伐	bùfá	pace
部署	bùshǔ	deploy
部位	bùwèi	part; section
才干	cáigàn	talent
财富	cáifù	wealth
财务	cáiwù	financial affairs
财政	cáizhèng	finance
裁缝	cáifeng	tailor
裁判	cáipàn	referee
裁员	cáiyuán	layoffs
采购	cǎigòu	purchase
采集	cǎijí	gather; collect
采纳	cǎinà	accept
彩票	cǎipiào	lottery
参谋	cānmóu	staff officer
参照	cānzhào	refer to
残疾	cánjí	a disability
残酷	cánkù	cruel
残留	cánliú	residual
残忍	cánrěn	brutal
灿烂	cànlàn	splendid
舱	cāng	cabin
苍白	cāngbái	pale
仓促	cāngcù	hasty
仓库	cāngkù	warehouse
操劳	cāoláo	work hard
操练	cāoliàn	drill; practice
操纵	cāozòng	control
操作	cāozuò	operation
嘈杂	cáozá	noisy
草案	cǎo'àn	draft
草率	cǎoshuài	cursory; jerry
策划	cèhuà	plan; hatch; plot
策略	cèlüè	tactic; policy
测量	cèliáng	measure
侧面	cèmiàn	side; flank
层出不穷	céngchūbùqióng	emerge in endlessly
层次	céngcì	gradation; arrangement
插座	chāzuò	socket
差别	chābié	difference
查获	cháhuò	hunt down and seize; ferret out
岔	chà	turn off; fork
刹那	chànà	instant
诧异	chàyì	astonished
柴油	cháiyóu	diesel oil
搀	chān	mix; mingle
馋	chán	greedy
缠绕	chánrào	twine
产业	chǎnyè	industry
阐述	chǎnshù	expatiate; expound
颤抖	chàndǒu	tremble
昌盛	chāngshèng	prosperity
尝试	chángshì	attempt
偿还	chánghuán	repay
场合	chǎnghé	occasion
场面	chǎngmiàn	scene
场所	chǎngsuǒ	place
敞开	chǎngkāi	open wide
倡导	chàngdǎo	advocate
倡议	chàngyì	initiative
畅通	chàngtōng	unimpeded; unblocked
畅销	chàngxiāo	sell well
超越	chāoyuè	transcend
钞票	chāopiào	bank note
朝代	cháodài	dynasty
潮流	cháoliú	trend
嘲笑	cháoxiào	ridicule
巢穴	cháoxué	nest
撤退	chètuì	haul off
撤销	chèxiāo	repeal; retract
沉淀	chéndiàn	subside
沉闷	chénmèn	oppressive; withdrawn
沉思	chénsī	meditation
沉重	chénzhòng	heavy
沉着	chénzhuó	composed; cool headed
陈旧	chénjiù	obsolete
陈列	chénliè	display
陈述	chénshù	present; state; mention
衬托	chèntuō	set off
称心如意	chènxīnrúyì	as one wishes
称号	chēnghào	title
盛	chéng	fill
橙	chéng	orange
乘	chéng	ride
承办	chéngbàn	undertake
承包	chéngbāo	contract
承诺	chéngnuò	promise
城堡	chéngbǎo	castle
成本	chéngběn	cost
成交	chéngjiāo	deal
成天	chéngtiān	all day long
成效	chéngxiào	results, effects
成心	chéngxīn	on purpose
成员	chéngyuán	member
惩罚	chéngfá	punish
诚挚	chéngzhì	sincere; cordial; earnest
澄清	chéngqīng	clarify
呈现	chéngxiàn	present
秤	chèng	balance
吃苦	chīkǔ	hardship
吃力	chīlì	sweaty
迟钝	chídùn	bluntness
迟缓	chíhuǎn	tardy; sluggish
迟疑	chíyí	hesitation
持久	chíjiǔ	lasting
赤道	chìdào	equator
赤字	chìzì	deficit; red ink
冲动	chōngdòng	impulse
冲击	chōngjī	to attack
冲突	chōngtū	conflict
充当	chōngdāng	act as; serve as
充沛	chōngpèi	abundant
充实	chōngshí	enrich
充足	chōngzú	adequate
崇拜	chóngbài	worship
崇高	chónggāo	lofty
崇敬	chóngjìng	respect; revere
重叠	chóngdié	overlap
筹备	chóubèi	arrange; prepare
稠密	chóumì	thick; dense
丑恶	chǒu'è	ugly; filthy
出路	chūlù	way out
出卖	chūmài	sell
出身	chūshēn	birth
出神	chūshén	trance
出息	chūxi	good
初步	chūbù	preliminary
除	chú	except
储备	chǔbèi	store
储存	chǔcún	storage
储蓄	chǔxù	save up; bank
处分	chǔfèn	prescription
处境	chǔjìng	plight; situation
处置	chǔzhì	treat; dispose
触犯	chùfàn	offend; violate
穿越	chuānyuè	pass through
川流不息	chuānliúbùxī	flowing up in an endless stream
船舶	chuánbó	watercraft; ships
传达	chuándá	convey
传单	chuándān	fly sheet; leaflet
传授	chuánshòu	initiate; teach
喘气	chuǎnqì	panting
串	chuàn	strand, cluster
床单	chuángdān	sheet
创立	chuànglì	found
创新	chuàngxīn	innovate
创业	chuàngyè	carve out
创作	chuàngzuò	a literary creation
吹牛	chuīniú	brag; boast
吹捧	chuīpěng	flatter; puff
炊烟	chuīyān	cooking smoke
锤	chuí	hammer
垂直	chuízhí	vertical
纯粹	chúncuì	pure
纯洁	chúnjié	pure
磁带	cídài	magnetic tape
慈祥	cíxiáng	kindly
慈善	císhàn	charity
雌雄	cíxióng	male and female
刺	cì	thorn
次品	cìpǐn	defective goods
次序	cìxù	order; sequence
伺候	cìhou	wait
丛	cóng	cluster
从容	cóngróng	take one's time; calm and unhurried
凑合	còuhuo	gather together
粗鲁	cūlǔ	rude
窜	cuàn	channeling
摧残	cuīcán	devastate; wreck
脆弱	cuìruò	fragile
搓	cuō	rub
磋商	cuōshāng	negotiate
挫折	cuòzhé	frustration
搭	dā	to match, to take
搭档	dādàng	partner
搭配	dāpèi	arrange; match
答辩	dábiàn	reply; answer
答复	dáfù	reply
达成	dáchéng	reach
打包	dǎbāo	pack
打官司	dǎguānsi	to engage in a lawsuit
打击	dǎjī	strike
打架	dǎjià	fight
打量	dǎliang	look sb. up and down
打猎	dǎliè	go hunting
打仗	dǎzhàng	to war
大不了	dàbuliǎo	big deal
大臣	dàchén	minister
大伙儿	dàhuǒr	you all; everybody
大肆	dàsì	wantonly
大体	dàtǐ	general
大意	dàyi	careless
大致	dàzhì	roughly
歹徒	dǎitú	gangster; mobster
带领	dàilǐng	lead
代价	dàijià	cost
代理	dàilǐ	agent
逮捕	dàibǔ	arrest
怠慢	dàimàn	cold-shoulder
担保	dānbǎo	assure; hypothecate
胆怯	dǎnqiè	coward, fear
淡季	dànjì	low season
淡水	dànshuǐ	fresh water
蛋白质	dànbáizhì	protein
诞辰	dànchén	birthday
诞生	dànshēng	be born
当场	dāngchǎng	on the spot
当初	dāngchū	original
当代	dāngdài	contemporary
当面	dāngmiàn	face to face
当前	dāngqián	current
当事人	dāngshìrén	client
当务之急	dāngwùzhījí	a pressing matter of the moment
当选	dāngxuǎn	be elected; come in
党	dǎng	party
档案	dàng'àn	archives
档次	dàngcì	grade
倒闭	dǎobì	collapse
导弹	dǎodàn	missile
导航	dǎoháng	navigate
导向	dǎoxiàng	guide
捣乱	dǎoluàn	trouble
稻谷	dàogǔ	unhusked rice
盗窃	dàoqiè	steal; pilfer
得不偿失	débùchángshī	be not worth the candle; get more kicks than halfpence
得力	délì	right-hand
得天独厚	détiāndúhòu	be richly endowed by nature
得罪	dézuì	offend
蹬	dēng	thrust 
灯笼	dēnglong	lantern
登陆	dēnglù	disembark; land
登录	dēnglù	sign in
等候	děnghòu	wait
等级	děngjí	grade; rank
瞪	dèng	stare
堤坝	dībà	dam
敌视	díshì	be hostile to; antagonize
抵达	dǐdá	arrive
抵抗	dǐkàng	resistance
抵制	dǐzhì	resist; reject; repel
递增	dìzēng	increasing
地步	dìbù	condition; plight; situation; state; extent
地势	dìshì	terrain
地质	dìzhì	geology
颠簸	diānbǒ	bump; welter
颠倒	diāndǎo	upside down
点缀	diǎnzhuì	embellishment
典礼	diǎnlǐ	ceremony
典型	diǎnxíng	typical
垫	diàn	pad
电源	diànyuán	power supply
奠定	diàndìng	establish
惦记	diànjì	miss
叼	diāo	hold in mouth
雕刻	diāokè	carving
雕塑	diāosù	sculpture
吊	diào	crane
调动	diàodòng	transfer
跌	diē	fall
丁	dīng	4th heavenly stem
盯	dīng	stare at
叮嘱	dīngzhǔ	urge again and again; exhort; warn
定期	dìngqī	regular
定义	dìngyì	definition
丢人	diūrén	lose face
丢三落四	diūsānlàsì	miss or lose this and that
东道主	dōngdàozhǔ	host
东张西望	dōngzhāngxīwàng	look around
董事长	dǒngshìzhǎng	chairman
栋	dòng	building (measure word)
冻结	dòngjié	frozen
动荡	dòngdàng	turbulence
动机	dòngjī	motivation
动静	dòngjing	movement
动力	dònglì	power, motivation
动脉	dòngmài	artery
动身	dòngshēn	leave
动手	dòngshǒu	DIY
动态	dòngtài	dynamic
动员	dòngyuán	mobilization
兜	dōu	pocket
陡峭	dǒuqiào	steep
斗争	dòuzhēng	struggle
督促	dūcù	supervise and urge
独裁	dúcái	autocracy
毒品	dúpǐn	narcotics
赌博	dǔbó	gambling
堵塞	dǔsè	blocking
杜绝	dùjué	stop， ban
端	duān	end
端午节	uānwǔjié	the Dragon Boat Festival
端正	duānzhèng	correct
短促	duǎncù	very brief
断定	duàndìng	be sure; figure out
断绝	duànjué	be sure; figure out
堆积	duījī	accumulation
对策	duìcè	countermeasure
对称	duìchèn	symmetrical
对付	duìfu	deal with
对抗	duìkàng	combat
对立	duìlì	opposition
对联	duìlián	antithetical couplet
对应	duìyìng	corresponding
对照	duìzhào	compare; collate
兑现	duìxiàn	cash
队伍	duìwu	ranks
顿时	dùnshí	suddenly
多元化	duōyuánhuà	diversification
哆嗦	duōsuo	shiver
堕落	duòluò	degenerate
额外	éwài	extra; additional
恶心	ěxin	disgusting
恶化	èhuà	deteriorate
遏制	èzhì	contain
恩怨	ēnyuàn	resentment
而已	éryǐ	nothing more
二氧化碳	èryǎnghuàtàn	carbon dioxide
发布	fābù	release
发财	fācái	make a fortune; make a pile
发呆	fādāi	in a daze
发动	fādòng	launch
发觉	fājué	find
发射	fāshè	launch
发誓	fāshì	swear
发行	fāxíng	issue
发炎	fāyán	inflammation
发扬	fāyáng	carry forward
发育	fāyù	development, growth
法人	fǎrén	juridical person
番	fān	some
繁华	fánhuá	bustling
繁忙	fánmáng	busy
繁体字	fántǐzì	the traditional Chinese character
繁殖	fánzhí	reproduction
凡是	fánshì	all
反驳	fǎnbó	refute
反常	fǎncháng	abnormal
反感	fǎngǎn	disgusted
反抗	fǎnkàng	resistance
反馈	fǎnkuì	feedback
反面	fǎnmiàn	the other side
反射	fǎnshè	echo; reflect
反思	fǎnsī	reflect
反问	fǎnwèn	rhetorical question
反之	fǎnzhī	on the contrary; whereas
范畴	fànchóu	category
泛滥	fànlàn	flood
贩卖	fànmài	trafficking
方位	fāngwèi	position
方言	fāngyán	dialect
方圆	fāngyuán	circumference
方针	fāngzhēn	policy
防守	fángshǒu	defense
防御	fángyù	defense
防止	fángzhǐ	prevent
防治	fángzhì	prevention and cure
访问	fǎngwèn	visit
纺织	fǎngzhī	spin
放大	fàngdà	enlarge
放射	fàngshè	radiation
非法	fēifǎ	illegal
飞禽走兽	fēiqínzǒushòu	birds and animals
飞翔	fēixiáng	flight
飞跃	fēiyuè	leap
肥沃	féiwò	fertile
诽谤	fěibàng	slander; defame
肺	fèi	lung
废除	fèichú	abolish
废墟	fèixū	ruins
废寝忘食	fèiqǐnwàngshí	forget all about sleeping and eating
沸腾	fèiténg	boiling
分辨	fēnbiàn	distinguish
分寸	fēncùn	sense of propriety
分红	fēnhóng	bonus
分解	fēnjiě	decompose
分裂	fēnliè	division
分泌	fēnmì	secretion
分明	fēnmíng	clear
分歧	fēnqí	divergence
分散	fēnsàn	dispersed
吩咐	fēnfù	tell
坟墓	fénmù	grave
粉末	fěnmò	powder
粉色	fěnsè	pink
粉碎	fěnsuì	smash
分量	fènliàng	weight
愤怒	fènnù	anger
风暴	fēngbào	storm
风度	fēngdù	manner
风光	fēngguāng	scenery
风气	fēngqì	atmosphere
风趣	fēngqù	funny
风土人情	fēngtǔrénqíng	local customs and practices
风味	fēngwèi	flavor
封闭	fēngbì	close
封建	fēngjiàn	feudal
封锁	fēngsuǒ	blockade
丰满	fēngmǎn	plump
丰盛	fēngshèng	rich; sumptuous
丰收	fēngshōu	have bumper harvest
锋利	fēnglì	sharp
逢	féng	meet; come upon
奉献	fèngxiàn	dedicate
否决	fǒujué	veto; reject; overrule
夫妇	fūfù	couple
夫人	fūrén	madam
敷衍	fūyǎn	play at
幅度	fúdù	range; extent
服从	fúcóng	obey
服气	fúqì	be convinced
符号	fúhào	symbol
福利	fúlì	welfare
福气	fúqi	good luck; felicity
俘虏	fúlǔ	captive
辐射	fúshè	radiation
腐败	fǔbài	corrupt
腐烂	fǔlàn	decay
腐蚀	fǔshí	corrosion
腐朽	fǔxiǔ	decadent
辅助	fǔzhù	auxiliary
抚养	fǔyǎng	raise
抚摸	fǔmō	stroke
俯视	fǔshì	look down
富裕	fùyù	affluent
副	fù	vice-
负担	fùdān	burden
覆盖	fùgài	overlay; cover with
附和	fùhè	chime in with; come to heel
附件	fùjiàn	enclosure
附属	fùshǔ	attach appertain
复活	fùhuó	resurrection
复兴	fùxīng	revival
腹泻	fùxiè	diarrhea
赋予	fùyǔ	give
改良	gǎiliáng	improvement
盖章	gàizhāng	seal
钙	gài	calcium
干旱	gānhàn	drought
干扰	gānrǎo	interfere
干涉	gānshè	interference
干预	gānyù	intervene
尴尬	gāngà	awkward
感慨	gǎnkǎi	feeling
感染	gǎnrǎn	infected
干劲	gànjìn	drive
纲领	gānglǐng	programme
港口	gǎngkǒu	port
港湾	gǎngwān	harbour
岗位	gǎngwèi	post
杠杆	gànggǎn	lever
高超	gāochāo	outstanding; superb; excellent
高潮	gāocháo	climax
高峰	gāofēng	peak
高明	gāomíng	brilliant; bright
高尚	gāoshàng	noble
高涨	gāozhǎng	upsurge
稿件	gǎojiàn	manuscript
告辞	gàocí	take leave
告诫	gàojiè	warn; caution
割	gē	cut
搁	gē	put aside
疙瘩	gēda	lump; pimple
歌颂	gēsòng	sing
鸽子	gēzi	dove
隔阂	géhé	estrangement
隔离	gélí	quarantine
格局	géjú	situation
格式	géshi	format
革命	gémìng	revolution
个体	gètǐ	individual
各抒己见	gèshūjǐjiàn	each airs his own views
根深蒂固	gēnshēndìgù	being deeply rooted; in grain
根源	gēnyuán	root
跟前	gēnqián	in front of
跟随	gēnsuí	follow
跟踪	gēnzōng	run after; tail
耕地	gēngdì	cultivated land
更新	gēngxīn	renovate; renew
更正	gēngzhèng	correct
公安局	gōng'ānjú	bureau of public security
公道	gōngdao	fair
公告	gōnggào	notice
公关	gōngguān	public relations
公民	gōngmín	citizen
公然	gōngrán	to the teeth; under one's nose
公认	gōngrèn	accepted
公式	gōngshì	formula
公务	gōngwù	official business
公正	gōngzhèng	fair
公证	gōngzhèng	notarization
供不应求	gōngbúyìngqiú	demand exceeds supply
供给	gōngjǐ	supply
工艺品	gōngyìpǐn	arts and crafts
宫殿	gōngdiàn	palace
功劳	gōngláo	credit
功效	gōngxiào	effect
攻击	gōngjī	attack
攻克	gōngkè	conquer
恭敬	gōngjìng	dutiful; respectful
巩固	gǒnggù	consolidate
共和国	gònghéguó	republic
共计	gòngjì	count up to; sum to
共鸣	gòngmíng	resonance
勾结	gōujié	collusion
钩子	gōuzi	hook
构思	gòusī	design
孤独	gūdú	lonely
孤立	gūlì	isolated
辜负	gūfù	live up to
姑且	gūqiě	tentatively
古董	gǔdǒng	antique
古怪	gǔguài	cranky; wacky
股东	gǔdōng	stockholder
股份	gǔfèn	shares
鼓动	gǔdòng	agitation
骨干	gǔgàn	backbone
固然	gùrán	of course
固体	gùtǐ	solid
固有	gùyǒu	inherent
固执	gùzhi	stubborn
顾虑	gùlǜ	misgive; misgiving
顾问	gùwèn	adviser
故乡	gùxiāng	hometown
故障	gùzhàng	fault
雇佣	gùyōng	hire
拐杖	guǎizhàng	cane
关怀	guānhuái	care
关照	guānzhào	take care of
官方	guānfāng	by the government official
观光	guānguāng	sightseeing
管辖	guǎnxiá	dominate; rule
罐	guàn	pot
贯彻	guànchè	implement
灌溉	guàngài	irrigation
惯例	guànlì	convention
光彩	guāngcǎi	brilliance
光辉	guānghuī	glory
光芒	guāngmáng	shine
光荣	guāngróng	glory
广阔	guǎngkuò	wide
规范	guīfàn	criterion; rule
规格	guīgé	standard; format
规划	guīhuà	plan
规章	guīzhāng	rules
归根到底	guīgēndàodǐ	at all time and place
归还	guīhuán	return
轨道	guǐdào	track
跪	guì	kneel
贵族	guìzú	noble
棍棒	gùnbàng	club; cudgel
国防	guófáng	national defense
国务院	guówùyuàn	the State Council
果断	guǒduàn	decisive
过度	guòdù	excessive
过渡	guòdù	transition
过奖	guòjiǎng	you flatter
过滤	guòlǜ	filter
过失	guòshī	fault
过问	guòwèn	ask
过瘾	guòyǐn	fun
过于	guòyú	too; excessively
嗨	hāi	hi
海拔	hǎibá	altitude
海滨	hǎibīn	seaside
含糊	hánhu	vague
含义	hányì	signification; meanings
寒暄	hánxuān	exchange of conventional greetings
罕见	hǎnjiàn	peculiar; rare
捍卫	hànwèi	defend; guard
航空	hángkōng	aviation
航天	hángtiān	space flight
航行	hángxíng	sail
行列	hángliè	ranks
豪迈	háomài	heroic
毫米	háomǐ	millimeter
毫无	háowú	nothing
号召	hàozhào	call
耗费	hàofèi	cost
呵	hē	oh
和蔼	hé'ǎi	kindly
和解	héjiě	compromise
和睦	hémù	harmony
和气	héqi	kind; polite
和谐	héxié	harmonious
合并	hébìng	merge
合成	héchéng	synthesis
合伙	héhuǒ	cooperate; join hands with
合算	hésuàn	cost-effective
嘿	hēi	hey
痕迹	hénjì	mark
狠心	hěnxīn	cruel hearted
恨不得	hènbude	hate not
哼	hēng	hum
横	héng	harsh and unreasonable; perverse
哄	hōng	fool
烘	hōng	bake
轰动	hōngdòng	make a sensation; make a stir
宏观	hóngguān	macroscopic
宏伟	hóngwěi	grand
洪水	hóngshuǐ	flood
喉咙	hóulóng	throat
吼	hǒu	roar
后代	hòudài	offspring
后顾之忧	hòugùzhīyōu	any menace from the rear
后勤	hòuqín	logistics
候选	hòuxuǎn	candidate
忽略	hūlüè	ignore
呼唤	hūhuàn	call
呼啸	hūxiào	whistling
呼吁	hūyù	call on; appeal
胡乱	húluàn	casually
胡须	húxū	beard
湖泊	húpō	lake
花瓣	huābàn	petal
花蕾	huālěi	bud
华丽	huálì	design
华侨	huáqiáo	overseas Chinese
画蛇添足	huàshétiānzú	superfluous
化肥	huàféi	chemical fertilizer
化石	huàshí	fossil
化验	huàyàn	test
化妆	huàzhuāng	prink; make up
划分	huàfēn	divide
话筒	huàtǒng	microphone
欢乐	huānlè	happy
还原	huányuán	reduction
环节	huánjié	link
缓和	huǎnhé	to moderate
患者	huànzhě	patient
荒凉	huāngliáng	desolate
荒谬	huāngmiù	ridiculous; nonsensical
荒唐	huāngtáng	absurd
黄昏	huánghūn	dusk
皇帝	huángdì	emperor
皇后	huánghòu	queen
晃	huǎng	shake
恍然大悟	huǎngrándàwù	see light suddenly
挥霍	huīhuò	splurge; devour
辉煌	huīhuáng	brilliant
回报	huíbào	return
回避	huíbì	obviate; slide over
回顾	huígù	review; look back
回收	huíshōu	recovery
悔恨	huǐhèn	regret
毁灭	huǐmiè	ruin
会晤	huìwù	meet
汇报	huìbào	report
贿赂	huìlù	bribery
昏迷	hūnmí	coma
荤	hūn	meat
浑身	húnshēn	all
混合	hùnhé	blend
混乱	hùnluàn	confusion
混淆	hùnxiáo	confusion
混浊	hùnzhuó	turbidity
活该	huógāi	you deserves it
活力	huólì	energy; vigor
火箭	huǒjiàn	rocket
火焰	huǒyàn	flame
火药	huǒyào	gunpowder
货币	huòbì	currency
基地	jīdì	base
基金	jījīn	fund
基因	jīyīn	gene
机动	jīdòng	maneuver
机构	jīgòu	mechanism
机灵	jīling	wise; clever
机密	jīmì	confidential
机械	jīxiè	mechanics
机遇	jīyù	opportunity
机智	jīzhì	tactful; resourceful
激发	jīfā	inspire
激励	jīlì	inspirit
激情	jīqíng	passion
饥饿	jī'è	hunger
讥笑	jīxiào	fleer
极端	jíduān	extreme
极限	jíxiàn	limit
即便	jíbiàn	even if
即将	jíjiāng	soon
级别	jíbié	level
疾病	jíbìng	disease
嫉妒	jídù	envy
及早	jízǎo	as soon as possible
急功近利	jígōngjìnlì	be anxious to achieve quick success and get instant benefits
急剧	jíjù	sharp
急切	jíqiè	impatient eager; imperative
急于求成	jíyúqiúchéng	be anxious for success
急躁	jízào	impatient
籍贯	jíguàn	place of origin
集团	jítuán	group
吉祥	jíxiáng	lucky; auspicious
给予	jǐyǔ	give
寄托	jìtuō	place on; consign or commit
继承	jìchéng	inherit
记性	jìxing	memory
记载	jìzǎi	record
季度	jìdù	quarter (of a year)
季军	jìjūn	third place
计较	jìjiào	regardless of
忌讳	jìhuì	taboo
寂静	jìjìng	silent
纪要	jìyào	summary
技巧	jìqiǎo	skill
迹象	jìxiàng	sign
家常	jiācháng	the daily life of a family
家伙	jiāhuo	fellow
家属	jiāshǔ	family members
家喻户晓	jiāyùhùxiǎo	widely known
加工	jiāgōng	machining
加剧	jiājù	exacerbate
佳肴	jiāyáo	delicacy
夹杂	jiāzá	inclusion
煎	jiān	fried
坚定	jiāndìng	firm, steadfast
坚固	jiāngù	strong
坚韧	jiānrèn	gritty; hard-bitten
坚实	jiānshí	solid
坚硬	jiānyìng	hard
监督	jiāndū	supervise
监视	jiānshì	monitor
监狱	jiānyù	prison
尖端	jiānduān	top end
尖锐	jiānruì	sharp
艰难	jiānnán	difficult
拣	jiǎn	pick
剪彩	jiǎncǎi	ribbon-cutting
检讨	jiǎntǎo	a review
检验	jiǎnyàn	test
简化	jiǎnhuà	predigest
简陋	jiǎnlòu	simple and crude
简体字	jiǎntǐzì	simplified character
简要	jiǎnyào	in brief
溅	jiàn	splash
鉴别	jiànbié	differentiate
鉴定	jiàndìng	appraisal
鉴于	jiànyú	in view of the fact that
间谍	jiàndié	espionage
间隔	jiàngé	interval
间接	jiànjiē	indirect
见多识广	jiànduōshíguǎng	have great experience
见解	jiànjiě	opinion
见闻	jiànwén	informative
见义勇为	jiànyìyǒngwéi	do boldly what is righteous
健全	jiànquán	sound
践踏	jiàntà	override
舰艇	jiàntǐng	naval vessels
剑	jiàn	sword
将近	jiāngjìn	nearly
将军	jiāngjūn	general
将就	jiāng jiù	put up with
僵硬	jiāngyìng	stiff
桨	jiǎng	propeller
奖励	jiǎnglì	reward
奖赏	jiǎngshǎng	reward
降临	jiànglín	become of; befall; arrive
交叉	jiāochā	intercross
交代	jiāodài	hand over
交涉	jiāoshè	negotiate
交易	jiāoyì	transaction
焦点	jiāodiǎn	focus
焦急	jiāojí	anxious
娇气	jiāoqì	effeminate
角落	jiǎoluò	corner
搅拌	jiǎobàn	mix up
缴纳	jiǎonà	pay
侥幸	jiǎoxìng	by luck
教养	jiàoyǎng	train; upbringing; education
较量	jiàoliàng	contest
皆	jiē	all
接连	jiēlián	one after another
阶层	jiēcéng	stratum
揭露	jiēlù	expose
节奏	jiézòu	rhythm
节制	jiézhì	dicipline
杰出	jiéchū	outstanding
结晶	jiéjīng	result; finale
结局	jiéjú	ending
结算	jiésuàn	settlement
竭尽全力	jiéjìnquánlì	strain every nerve
截至	jiézhì	by (time）
截止	jiézhǐ	due
解除	jiěchú	relieve
解放	jiěfàng	liberate
解雇	jiěgù	fire
解剖	jiěpōu	anatomy
解散	jiěsàn	dissolution
解体	jiětǐ	disintegrate
借鉴	jièjiàn	take example by
借助	jièzhù	with the help of
戒备	jièbèi	alert
界限	jièxiàn	limit
津津有味	jīnjīnyǒuwèi	eat with appetite
金融	jīnróng	finance
紧迫	jǐnpò	urgent
锦上添花	jǐnshàngtiānhuā	icing on the cake
进而	jìn'ér	and then
进攻	jìngōng	attack
进化	jìnhuà	evolution
进展	jìnzhǎn	evolve; get along
近来	jìnlái	recently
浸泡	jìnpào	soak
晋升	jìnshēng	promotion
茎	jīng	stalk; stem
精打细算	jīngdǎxìsuàn	pinch pennies
精华	jīnghuá	elite; distillate
精简	jīngjiǎn	simplify; condense
精密	jīngmì	exact; close
精确	jīngquè	accurate; exact
精通	jīngtōng	master, be good at
精心	jīngxīn	elaborate
精益求精	jīngyìqiújīng	keep improving
精致	jīngzhì	delicate
经费	jīngfèi	funds
经纬	jīngwěi	longitude and latitude
惊动	jīngdòng	disturb
惊奇	jīngqí	be surprised
惊讶	jīngyà	surprised
兢兢业业	jīngjīngyèyè	cautious and conscientious
井	jǐng	well
警告	jǐnggào	warning
警惕	jǐngtì	be vigilant
颈椎	jǐngzhuī	cervical vertebra
敬礼	jìnglǐ	salute
敬业	jìngyè	dedication (work)
境界	jìngjiè	realm; extent reached
竞赛	jìngsài	competition
竞选	jìngxuǎn	campaign for
镜头	jìngtóu	camera lens
纠纷	jiūfēn	dissension; tangle
纠正	jiūzhèng	correct
酒精	jiǔjīng	alcohol
救济	jiùjì	redress; relief
就近	jiùjìn	nearby
就业	jiùyè	take up an occupation
就职	jiùzhí	inauguration
鞠躬	jūgōng	bow
拘留	jūliú	detain
拘束	jūshù	constrained; ill at ease
居民	jūmín	residents
居住	jūzhù	live
局部	júbù	local
局面	júmiàn	situation
局势	júshì	situation
局限	júxiàn	limit; confine
举动	jǔdòng	move
举世瞩目	jǔshìzhǔmù	attract worldwide attention
举足轻重	jǔzúqīngzhòng	play a decisive role
咀嚼	jǔjué	chew
沮丧	jǔsàng	depressed
剧本	jùběn	script
剧烈	jùliè	severe
聚精会神	jùjīnghuìshén	concentrate one's attention on
据悉	jùxī	it is reported
卷	juàn	volume
决策	juécè	make policy
觉悟	juéwù	consciousness
觉醒	juéxǐng	rouse; awake
绝望	juéwàng	despair
倔强	juéjiàng	stubborn
军队	jūnduì	army
君子	jūnzǐ	gentleman
卡通	kǎtōng	cartoon
开采	kāicǎi	exploit (mine)
开除	kāichú	expel
开阔	kāikuò	open
开朗	kāilǎng	optimistic
开明	kāimíng	enlightened
开辟	kāipì	open up
开拓	kāituò	open up; exploit
开展	kāizhǎn	develop
开支	kāizhī	expenditure
刊登	kāndēng	publish in a newspaper
刊物	kānwù	publication
勘探	kāntàn	prospect for; prove up
砍伐	kǎnfá	lop
侃侃而谈	kǎnkǎn ér tán	chatting
看待	kàndài	to view
慷慨	kāngkǎi	generous
扛	káng	carry
抗议	kàngyì	protest
考察	kǎochá	investigate
考古	kǎogǔ	archaeology
考核	kǎohé	examine; assess
考验	kǎoyàn	test
靠拢	kàolǒng	close to
磕	kē	knock
科目	kēmù	subject
渴望	kěwàng	yearn
可观	kěguān	considerable
可口	kěkǒu	delicious
可恶	kěwù	loathsome; hateful
可行	kěxíng	feasible
刻不容缓	kèbùrónghuǎn	brook no delay
课题	kètí	topic
克制	kèzhì	restrain
客户	kèhù	customer
啃	kěn	bite
恳切	kěnqiè	fair-spoken
坑	kēng	pit
空洞	kōngdòng	empty
空前绝后	kōngqiánjuéhòu	unprecedented
空想	kōngxiǎng	escapism; dream; phantasm
空虚	kōngxū	vain; empty
孔	kǒng	hole
恐怖	kǒngbù	terror
恐吓	kǒnghè	intimidate
恐惧	kǒngjù	fear
空白	kòngbái	blank; vacancy
空隙	kòngxì	interspaced; lacuna
口气	kǒuqì	tone
口腔	kǒuqiāng	mouth; oral cavity
口头	kǒutóu	oral
口音	kǒuyīn	accent
扣	kòu	button
哭泣	kūqì	cry
枯燥	kūzào	boring
枯萎	kūwěi	withered
苦涩	kǔsè	bitter
苦尽甘来	kǔjìngānlái	all sufferings have their reward
挎	kuà	carry on the arm
跨	kuà	cross
快活	kuàihuo	happy
宽敞	kuānchang	spacious; commodious
宽容	kuānróng	tolerant
款待	kuǎndài	entertain
款式	kuǎnshì	style
筐	kuāng	basket
旷课	kuàngkè	absenteeism
框架	kuàngjià	frame
况且	kuàngqiě	moreover
矿产	kuàngchǎn	mineral
亏待	kuīdài	treat
亏损	kuīsǔn	loss
捆绑	kǔnbǎng	binding
扩充	kuòchōng	extend; enlarge
扩散	kuòsàn	spread
扩张	kuòzhāng	expand; outspread
喇叭	lǎba	horn
蜡烛	làzhú	candle
啦	la	contraction of 了啊
来历	láilì	origin
来源	láiyuán	source
栏目	lánmù	column
懒惰	lǎnduò	lazy
狼狈	lángbèi	in sore straits; in a tight corner
狼吞虎咽	lángtūnhǔyàn	devour like a wolf
捞	lāo	fishing
唠叨	láodao	to nag
牢固	láogù	solid
牢骚	láosāo	complain
乐趣	lèqù	pleasure
乐意	lèyì	happy
雷达	léidá	radar
类似	lèisì	similar
冷酷	lěngkù	cool
冷却	lěngquè	cooling
冷落	lěngluò	indiffenrent
愣	lèng	distracted
黎明	límíng	dawn
里程碑	lǐchéngbēi	milepost
礼节	lǐjié	etiquette
礼尚往来	lǐshàngwǎnglái	reci[rocity
理睬	lǐcǎi	acknowledge
理所当然	lǐsuǒdāngrán	go without saying; of course
理直气壮	lǐzhíqìzhuàng	one is assured and bold with justice
理智	lǐzhì	reasonable
粒	lì	grain (measure word)
立场	lìchǎng	position
立方	lìfāng	cube
立交桥	lìjiāoqiáo	overpass
立体	lìtǐ	three-dimensional
立足	lìzú	based on the
历代	lìdài	past dynasties
历来	lìlái	always
利害	lìhài	interest
力所能及	lìsuǒnéngjí	do everything in one's power
力争	lìzhēng	strive to
力求	lìqiú	strive for
例外	lìwài	exception
连年	liánnián	in successive years
连锁	liánsuǒ	chain
连同	liántóng	together with
联欢	liánhuān	gala
联络	liánluò	liaison
联盟	liánméng	union
联想	liánxiǎng	association
廉洁	liánjié	uncorrupted; clean-fingered
良心	liángxīn	conscience
晾	liàng	dry
谅解	liàngjiě	understanding
辽阔	liáokuò	vast
列举	lièjǔ	list
淋	lín	shower
临床	línchuáng	clinical
吝啬	lìnsè	stingy
零星	língxīng	sporadic
凌晨	língchén	before dawn
灵感	línggǎn	inspiration
灵魂	línghún	soul
灵敏	língmǐn	sensitive
伶俐	línglì	clever
领会	lǐnghuì	understand
领事馆	lǐngshìguǎn	consulate
领土	lǐngtǔ	territory
领悟	lǐngwù	understand
领先	lǐngxiān	keep ahead
领袖	lǐngxiù	leader
溜	liū	slip
留恋	liúliàn	be reluctant to leave
留念	liúniàn	as a souvenir
留神	liúshén	watch
流浪	liúlàng	lead a vagrant life; rove; roam about
流露	liúlù	reveal
流氓	liúmáng	rogue
流通	liútōng	circulation
聋哑	lóngyǎ	deaf-mute
隆重	lóngzhòng	ceremonious
垄断	lǒngduàn	monopoly
笼罩	lǒngzhào	shrouded
搂	lǒu	hug
炉灶	lúzào	a kitchen stove
轮船	lúnchuán	ship
轮廓	lúnkuò	outline
轮胎	lúntāi	tyre
论坛	lùntán	forum
论证	lùnzhèng	demonstration
啰唆	luōsuo	troublesome, wordy
落成	luòchéng	completion
落实	luòshí	put into effect
络绎不绝	luòyìbùjué	go and fro in constant streams
屡次	lǚcì	repeatedly
履行	lǚxíng	perform
掠夺	lüèduó	plunder
麻痹	mábì	lull; blunt; paralysis
麻木	mámù	numbness
麻醉	mázuì	narcosis
码头	mǎtóu	wharf
蚂蚁	mǎyǐ	ant
嘛	ma	modal particle indicating that something is obvious
埋伏	máifú	ambush
埋没	máimò	immerse oneself in
埋葬	máizàng	bury
迈	mài	to take a step; to stride
脉搏	màibó	pulse
埋怨	mányuàn	complain
慢性	mànxìng	chronic
漫长	màncháng	very long
漫画	mànhuà	cartoon
蔓延	mànyán	spread; creep
忙碌	mánglù	be busy
茫茫	mángmáng	vast; boundless
茫然	mángrán	blank
盲目	mángmù	blind
冒充	màochōng	posing
冒犯	màofàn	offend
茂盛	màoshèng	lush
枚	méi	measure word for medal
媒介	méijiè	agent; medium
美观	měiguān	beautiful
美满	měimǎn	happy; perfect
美妙	měimiào	wonderful
萌芽	méngyá	bud; sprout
猛烈	měngliè	violent
眯	mī	take a nap
弥补	míbǔ	remedy; offset
弥漫	mímàn	permeate; fill the air
迷惑	míhuò	puzzle; delude
迷人	mírén	charming
迷信	míxìn	superstition
谜语	míyǔ	riddle
密度	mìdù	density
密封	mìfēng	seal up
棉花	miánhua	cotton
免得	miǎndé	lest
免疫	miǎnyì	immune
勉励	miǎnlì	encourage
勉强	miǎnqiǎng	reluctantly
面貌	miànmào	face
面子	miànzi	prestige; face
描绘	miáohuì	describe; portray
瞄准	miáozhǔn	aim 
渺小	miǎoxiǎo	tiny
藐视	miǎoshì	contempt
蔑视	mièshì	disparage; scorn
灭亡	mièwáng	perish
民间	mínjiān	nongovernmental
民主	mínzhǔ	democratic
敏捷	mǐnjié	agile
敏锐	mǐnruì	keen
明明	míngmíng	obviously
明智	míngzhì	wise
名次	míngcì	ranking
名额	míng'é	places
名副其实	míngfùqíshí	be worthy of the name
名誉	míngyù	reputation
命名	mìngmíng	call; nominate
摸索	mōsuǒ	fumble; grope
膜	mó	membrane
摩擦	mócā	rub; scrape
磨合	móhé	running-in
模范	mófàn	model
模式	móshì	mode; style
模型	móxíng	model
魔鬼	móguǐ	devil; demon
魔术	móshù	magic
抹杀	mǒshā	write off; obliterate
莫名其妙	mòmíng-qímiào	without rhyme or reason
默默	mòmò	silently
墨水儿	mòshuǐr	book learning
谋求	móuqiú	seek
模样	múyàng	appearance
母语	mǔyǔ	mother tongue
目睹	mùdǔ	witness; see with one's eyes
目光	mùguāng	eye
沐浴	mùyù	bath
拿手	náshǒu	good
纳闷儿	nàmènr	feel puzzle
耐用	nàiyòng	durable
南辕北辙	nányuánběizhé	have nothing in common
难得	nándé	rare
难堪	nánkān	embarrassed
难能可贵	nánnéngkěguì	praiseworthy for one's excellent conduct
恼火	nǎohuǒ	angry; take fire
内涵	nèihán	connotation
内幕	nèimù	insider
内在	nèizài	inherent
能量	néngliàng	energy
拟定	nǐdìng	study out
逆行	nìxíng	retrograde motion
年度	niándù	year
捏	niē	pinch
拧	níng	screw
凝固	nínggù	freezing
凝聚	níngjù	condensation
凝视	níngshì	gaze; stare
宁肯	nìngkěn	would rather than
宁愿	nìngyuàn	would rather
纽扣儿	niǔkòur	button
扭转	niǔzhuǎn	reverse
浓厚	nónghòu	dense
农历	nónglì	lunar calendar
奴隶	núlì	slave
挪	nuó	move; shift
虐待	nüèdài	to abuse
哦	o	oh
殴打	ōudǎ	beat up; hit; drub
偶像	ǒuxiàng	idol
呕吐	ǒutù	vomit
趴	pā	lie
排斥	páichì	exclude
排除	páichú	eliminate; remove; debar
排练	páiliàn	rehearse
排放	páifàng	discharge
徘徊	páihuái	wander
派别	pàibié	faction; group
派遣	pàiqiǎn	send; dispatch
攀登	pāndēng	climb
盘旋	pánxuán	convolute; hover
畔	pàn	bank, side
判决	pànjué	sentence
庞大	pángdà	enormous
抛弃	pāoqì	throw over; abandon; discard
泡沫	pàomò	bubble; froth
培育	péiyù	cultivation
配备	pèibèi	equipment
配偶	pèi'ǒu	consort; mate
配套	pèitào	form a complete set
盆地	péndì	basin
烹饪	pēngrèn	cooking
捧	pěng	holding
劈	pī	split
批发	pīfā	wholesale
批判	pīpàn	critique
疲惫	píbèi	tired out; exhausted
疲倦	píjuàn	tired
皮革	pígé	leather
屁股	pìgu	butt
譬如	pìrú	for example
偏差	piānchā	error; deviation
偏见	piānjiàn	prejudice
偏僻	piānpì	out of the way; devious; outlying
偏偏	piānpiān	just
片断	piànduàn	fragment
片刻	piànkè	a while; a moment
飘扬	piāoyáng	flying
漂浮	piāofú	float
撇	piē	cast aside
拼搏	pīnbó	go all out in work
拼命	pīnmìng	try my best
频繁	pínfán	frequently
频率	pínlǜ	frequency
贫乏	pínfá	poor; lacking indigent
贫困	pínkùn	poor
品尝	pǐncháng	taste
品德	pǐndé	character
品质	pǐnzhì	quality
品种	pǐnzhǒng	varieties
平凡	píngfán	ordinary
平面	píngmiàn	plane
平坦	píngtǎn	flat
平行	píngxíng	parallel
平原	píngyuán	plain
平庸	píngyōng	mediocre
评估	pínggū	evaluate
评论	pínglùn	comment
屏障	píngzhàng	wall; barrier
屏幕	píngmù	screen
坡	pō	slope
泼	pō	splash
颇	pō	quite; pretty
破例	pòlì	make an exception
迫不及待	pòbùjídài	unable to hold oneself back
迫害	pòhài	persecution
魄力	pòlì	courage
扑	pū	flutter
铺	pū	spread
普及	pǔjí	universal
朴实	pǔshí	simple
朴素	pǔsù	simple
瀑布	pùbù	waterfall
期望	qīwàng	expect
期限	qīxiàn	term
欺负	qīfu	bully
欺骗	qīpiàn	deception
凄凉	qīliáng	desolate
奇妙	qímiào	wonderful
旗袍	qípáo	cheongsam
旗帜	qízhì	flag
齐全	qíquán	complete; all ready
齐心协力	qíxīn-xiélì	make concerted efforts
歧视	qíshì	discrimination
起草	qǐcǎo	draft
起初	qǐchū	at first
起伏	qǐfú	undulate
起哄	qǐhòng	kick up a row
起码	qǐmǎ	minimum, at least
起源	qǐyuán	origin
启程	qǐchéng	set out
启示	qǐshì	enlightenment
启事	qǐshì	notice
启蒙	qǐméng	enlightenment
乞丐	qǐgài	beggar
企图	qǐtú	attempt
岂有此理	qǐyǒu-cǐlǐ	outrageous; preposterous
器材	qìcái	equipment
器官	qìguān	organ
气概	qìgài	spirit
气功	qìgōng	Qigong (a system of breathing technique)
气魄	qìpò	verve
气色	qìsè	look
气势	qìshì	vigor
气味	qìwèi	smell
气象	qìxiàng	meteorological
气压	qìyā	pressure
气质	qì zhì	temperament
迄今为止	qìjīn-wéizhǐ	so far
掐	qiā	pinch
恰当	qiàdàng	appropriate
恰到好处	qiàdàohǎochù	just right
恰巧	qiàqiǎo	just
洽谈	qiàtán	talk over with
牵	qiān	pull
牵扯	qiānchě	involved
牵制	qiānzhì	hold down
千方百计	qiānfāng-bǎijì	make every attempt
签署	qiānshǔ	sign; affix to; subscribe
迁就	qiānjiù	indulge
迁徙	qiānxǐ	migrate
谦逊	qiānxùn	modest
前景	qiánjǐng	prospect
前提	qiántí	precondition
潜力	qiánlì	potential
潜水	qiánshuǐ	diving
潜移默化	qiányí-mòhuà	influence character by environment
谴责	qiǎnzé	condemn; accuse; censure
强制	qiángzhì	force; oblige
抢劫	qiǎngjié	robbery
抢救	qiǎngjiù	rescue
强迫	qiǎngpò	force
桥梁	qiáoliáng	bridge
翘	qiào	to stick up; to rise on one end; to tilt
窍门	qiàomén	trick
锲而不舍	qiè'érbùshě	keep on carving
切实	qièshí	practical
亲密	qīnmì	close
亲热	qīnrè	affectionate
侵犯	qīnfàn	violation
侵略	qīnlüè	aggression
钦佩	qīnpèi	admire
勤俭	qínjiǎn	hardworking and thrifty
勤劳	qínláo	industrious
清澈	qīngchè	clear
清晨	qīngchén	early morning
清除	qīngchú	eliminate
清洁	qīngjié	clean
清理	qīnglǐ	clear
清晰	qīngxī	clear
清醒	qīngxǐng	sober
清真	qīngzhēn	Muslim
倾听	qīngtīng	listen for
倾向	qīngxiàng	inclination
倾斜	qīngxié	tilt
晴朗	qínglǎng	sunny
情报	qíngbào	intelligence
情节	qíngjié	plot
情理	qínglǐ	reason
情形	qíngxíng	situation
请柬	qǐngjiǎn	invitation card
请教	qǐngjiào	consult
请示	qǐngshì	for instructions
请帖	qǐngtiě	invitation
丘陵	qiūlíng	hill
区分	qūfēn	distinguish
区域	qūyù	region
屈服	qūfú	submit; give in; bend
曲折	qūzhé	tortuous
驱逐	qūzhú	drive out; banish
渠道	qúdào	channel
取缔	qǔdì	ban
曲子	qǔzi	tune
趣味	qùwèi	interest
圈套	quāntào	trap
全局	quánjú	overall situation
全力以赴	quánlìyǐfù	do one's level best; go all out
权衡	quánhéng	balance
权威	quánwēi	authority
拳头	quántou	fist
犬	quǎn	dog
缺口	quēkǒu	breach; gap
缺席	quēxí	absent
缺陷	quēxiàn	defect
瘸	qué	lame
确保	quèbǎo	ensure
确立	quèlì	establish
确切	quèqiè	exact; definite
确信	quèxìn	sure
群众	qúnzhòng	the masses
染	rǎn	dye
嚷	rǎng	shout
让步	ràngbù	give in; concede to
饶恕	ráoshù	forgive
扰乱	rǎoluàn	disturb
惹祸	rěhuò	trouble
热泪盈眶	rèlèi-yíngkuàng	one's eyes brimming with tears
热门	rèmén	hot
人道	réndào	humanity
人格	réngé	personality
人工	réngōng	artificial
人家	rénjiā	family
人间	rénjiān	human world
人士	rénshì	personage
人为	rénwéi	artificial
人性	rénxìng	human nature
人质	rénzhì	hostage
仁慈	réncí	kind
忍耐	rěnnài	exercise patience
忍受	rěnshòu	bear
认定	rèndìng	cognizance
认可	rènkě	certificate; ratify
任命	rènmìng	appointment
任性	rènxìng	wayward
任意	rènyì	arbitrarily
任重道远	rènzhòng-dàoyuǎn	take a heavy burden and embark on a long road
仍旧	réngjiù	still
日新月异	rìxīn-yuèyì	change rapidly
日益	rìyì	increasingly
融化	rónghuà	thaw
融洽	róngqià	harmonious
溶解	róngjiě	dissolve; melt
容貌	róngmào	appearance
容纳	róngnà	accommodate; contain; hold
容器	róngqì	container
容忍	róngrěn	tolerate
荣幸	róngxìng	to be honored
荣誉	róngyù	honor
揉	róu	knead
柔和	róuhé	soft
儒家	rújiā	confucianism
弱点	ruòdiǎn	weakness
若干	ruògān	a certain number or amount
撒谎	sāhuǎng	lie
散文	sǎnwén	prose
散布	sànbù	spread
散发	sànfā	emission
丧失	sàngshī	lose
骚扰	sāorǎo	harassment
嫂子	sǎozi	sister-in-law
刹车	shāchē	brake
啥	shá	what
筛选	shāixuǎn	screen
山脉	shānmài	mountain range
闪烁	shǎnshuò	twinkle
擅长	shàncháng	be good at
擅自	shànzì	do sth, without authorization
商标	shāngbiāo	trademark
伤脑筋	shāngnǎojīn	troublesome
上级	shàngjí	superior
上进	shàngjìn	desire to advance
上任	shàngrèn	take up an official post
上瘾	shàngyǐn	addiction
上游	shàngyóu	upper reaches
尚且	shàngqiě	yet
捎	shāo	take along sth. to sb
梢	shāo	end; tip
哨	shào	whistle
奢侈	shēchǐ	luxurious
舌头	shétou	tongue
设立	shèlì	establish
设想	shèxiǎng	imagine， conceive
设置	shèzhì	set up
社区	shèqū	community
涉及	shèjí	involve
摄氏度	shèshìdù	centigrade
深奥	shēn'ào	profound
深沉	shēnchén	deep
深情厚谊	shēnqíng-hòuyì	profound sentiments of friendship
申报	shēnbào	declare
绅士	shēnshì	gentleman
呻吟	shēnyín	moan
神经	shénjīng	nerve
神奇	shénqí	magical
神气	shénqì	air, expression
神圣	shénshèng	sacred
神态	shéntài	expression
神仙	shénxiān	supernatural being; immortal; fairy
审查	shěnchá	examination
审理	shěnlǐ	hear; try (law)
审美	shěnměi	taste
审判	shěnpàn	trial
渗透	shèntòu	infiltration
慎重	shènzhòng	careful
生存	shēngcún	existence
生机	shēngjī	vitality
生理	shēnglǐ	physiology
生疏	shēngshū	strange
生态	shēngtài	ecology
生物	shēngwù	biology
生肖	shēngxiào	Chinese zodiac
生效	shēngxiào	take effect
生锈	shēngxiù	rust
生育	shēngyù	birth
牲畜	shēngchù	livestock
声明	shēngmíng	statement
声势	shēngshì	impetus; momentum
声誉	shēngyù	reputation
省会	shěnghuì	provincial capital
盛产	shèngchǎn	abound in; teem with
盛开	shèngkāi	in full bloom
盛情	shèngqíng	boundless hospitality
盛行	shèngxíng	prevalence
胜负	shèngfù	victory and defeat
失事	shīshì	crash
失误	shīwù	an error
失踪	shīzōng	disappear
师范	shīfàn	normal school
施加	shījiā	exert
施展	shīzhǎn	display
尸体	shītǐ	body; cadaver
拾	shí	pick up, collect
十足	shízú	100 percent
识别	shíbié	distinguish
时常	shícháng	often
时而	shí'ér	from time to time; now … now …
时光	shíguāng	time
时机	shíjī	opportunity
时事	shíshì	current affairs
实惠	shíhuì	substantial
实力	shílì	strength
实施	shíshī	implementation
实事求是	shíshìqiúshì	seek truth from facts
实行	shíxíng	implement
实质	shízhì	essence
石油	shíyóu	petroleum
使命	shǐmìng	mission
是非	shìfēi	right and wrong; quarrel; dispute
试图	shìtú	try
试验	shìyàn	test
势必	shìbì	certainly will
势力	shìlì	power
世代	shìdài	generation
示范	shìfàn	lead the way; demonstrate
示威	shìwēi	demonstration
示意	shìyì	hint，signal
释放	shìfàng	release
事故	shìgù	accident
事迹	shìjì	deed， story
事件	shìjiàn	event
事态	shìtài	situation
事务	shìwù	affair
事项	shìxiàng	matter
事业	shìyè	career
适宜	shìyí	suitable
视力	shìlì	vision
视频	shìpín	video
视线	shìxiàn	sight
视野	shìyě	view
逝世	shìshì	death
收藏	shōucáng	collection
收缩	shōusuō	shrink
收益	shōuyì	income; profit
收音机	shōuyīnjī	radio
手法	shǒufǎ	technique
手势	shǒushì	gesture
手艺	shǒuyì	craft; handicraft
首要	shǒuyào	chief; principal
首饰	shǒushì	jewelry
守护	shǒuhù	guard
受罪	shòuzuì	suffer
授予	shòuyǔ	grant
书法	shūfǎ	calligraphy
书籍	shūjí	book
书记	shūjì	secretary
书面	shūmiàn	in written form
舒畅	shūchàng	happy, entirely free from worry
疏忽	shūhū	neglect
疏远	shūyuǎn	alienation
竖	shù	vertical
束	shù	beam
束缚	shùfù	shackles
树立	shùlì	establish
数额	shù'é	amount
耍	shuǎ	play
衰老	shuāilǎo	be senile, grow old
衰退	shuāituì	decline
率领	shuàilǐng	lead
涮火锅	shuànhuǒguō	have hotpot
双胞胎	shuāngbāotāi	horse hooves
爽快	shuǎngkuài	frank
水利	shuǐlì	water conservancy
水龙头	shuǐlóngtóu	water tap
水泥	shuǐní	cement
瞬间	shùnjiān	moment
司法	sīfǎ	judicial
司令	sīlìng	commander
思念	sīniàn	miss
思索	sīsuǒ	thinking
思维	sīwéi	thinking
私自	sīzì	secretly
斯文	sīwen	gentle
死亡	sǐwáng	death
四肢	sìzhī	limb
寺庙	sìmiào	temple
肆无忌惮	sìwújìdàn	act recklessly and care for nobody
饲养	sìyǎng	raise
耸	sǒng	shrug
艘	sōu	ship
苏醒	sūxǐng	wake up
俗话	súhuà	common saying
塑造	sùzào	model
素食	sùshí	vegetarian diet
素质	sùzhì	quality
诉讼	sùsòng	litigation
算数	suànshù	count
随即	suíjí	immediately
随意	suíyì	random; casual
岁月	suìyuè	years
隧道	suìdào	tunnel
损坏	sǔnhuài	damage
索性	suǒxìng	simply
索取	suǒqǔ	request
塌	tā	collapse
踏实	tāshi	earnest, steady and sure
塔	tǎ	tower
台风	táifēng	typhoon
太空	tàikōng	space
泰斗	tàidǒu	leading authority
瘫痪	tānhuàn	paralysis
贪婪	tānlán	greedy
贪污	tānwū	corruption
摊	tān	stall
弹性	tánxìng	elastic
坦白	tǎnbái	frank
探测	tàncè	probe
探索	tànsuǒ	explore
探讨	tàntǎo	discuss; probe into
探望	tànwàng	visit
叹气	tànqì	sigh
倘若	tǎngruò	if
掏	tāo	dig
滔滔不绝	tāotāobùjué	dash along; give it mouth
陶瓷	táocí	ceramics
陶醉	táozuì	revel in
淘汰	táotài	eliminate
讨好	tǎohǎo	to please someone
特长	tècháng	specialty
特定	tèdìng	given
特意	tèyì	specially
提拔	tíbá	elevate
提炼	tíliàn	abstract; refine
提示	tíshì	hint
提议	tíyì	proposal
题材	tícái	theme
体裁	tǐcái	genre
体积	tǐjī	volume
体谅	tǐliàng	understand; allow for
体面	tǐmiàn	respectable
体系	tǐxì	system
天才	tiāncái	genius
天伦之乐	tiānlúnzhīlè	the happiness of a family union
天然气	tiānránqì	natural gas
天生	tiānshēng	born
天堂	tiāntáng	heaven
天赋	tiānfù	talent
天文	tiānwén	astronomy
田径	tiánjìng	athletics
田野	tiányě	field
舔	tiǎn	lick
挑剔	tiāoti	fastidious
条款	tiáokuǎn	clause
条理	tiáolǐ	organized
条约	tiáoyuē	treaty
调和	tiáohé	reconcile
调剂	tiáojì	relief; temper
调节	tiáojié	adjust
调解	tiáojiě	mediate
调料	tiáoliào	seasoning
挑拨	tiǎobō	provoke
挑衅	tiǎoxìn	provocation
跳跃	tiàoyuè	jump
停泊	tíngbó	anchor
停顿	tíngdùn	pause
停滞	tíngzhì	stagnation
亭子	tíngzi	pavilion
挺拔	tǐngbá	tall and straight
通货膨胀	tōnghuòpéngzhàng	inflation
通俗	tōngsú	popular, common
通讯	tōngxùn	communication
通用	tōngyòng	currency
通缉	tōngjī	list as wanted
铜	tóng	copper
同胞	tóngbāo	compatriot
同志	tóngzhì	comrade
童话	tónghuà	fairy tale
统筹兼顾	tǒngchóujiāngù	take into consideration both needs of the state and the interests of the collectives
统计	tǒngjì	statistics
统统	tǒngtǒng	all
统治	tǒngzhì	rule
投机	tóujī	speculation
投票	tóupiào	vote
投诉	tóusù	complaint
投降	tóuxiáng	surrender
投掷	tóuzhì	throw
透露	tòulù	disclose
秃	tū	bald
突破	tūpò	breach
图案	tú'àn	pattern
徒弟	túdì	apprentice
途径	tújìng	channel
涂抹	túmǒ	apply
土壤	tǔrǎng	soil
吞吞吐吐	tūntūntǔtǔ	mutter and mumble
团结	tuánjié	unite
团体	tuántǐ	group
团圆	tuányuán	reunion
推测	tuīcè	speculation
推翻	tuīfān	overthrow
推理	tuīlǐ	reasoning
推论	tuīlùn	inference
推销	tuīxiāo	promote sales
脱离	tuōlí	be divorced from
拖延	tuōyán	delay
托运	tuōyùn	consignment
妥当	tuǒdang	appropriate
妥善	tuǒshàn	proper
妥协	tuǒxié	compromise
椭圆	tuǒyuán	ellipse
唾弃	tuòqì	cast aside
挖掘	wājué	excavate
娃娃	wáwa	a doll
瓦解	wǎjiě	collapse
哇	wa	wow
歪曲	wāiqū	distort
外表	wàibiǎo	appearance
外行	wàiháng	layman
外界	wàijiè	outside
外向	wàixiàng	extroversion
丸	wán	pill
完备	wánbèi	complete, maturity
完毕	wánbì	complete
玩弄	wánnòng	play with; flirt with
玩意儿	wányìr	thing
顽固	wángù	stubborn
顽强	wánqiáng	tenacious
挽回	wǎnhuí	to save
挽救	wǎnjiù	save
惋惜	wǎnxī	sorry
万分	wànfēn	extremely
往常	wǎngcháng	the usual
往事	wǎngshì	past
妄想	wàngxiǎng	mirage; deliria
微不足道	wēibùzúdào	not worth mentioning
微观	wēiguān	microcosmic
威风	wēifēng	prestige
威力	wēilì	power
威望	wēiwàng	prestige
威信	wēixìn	authority
危机	wēijī	crisis
违背	wéibèi	violation
维持	wéichí	maintain
维护	wéihù	protect
维生素	wéishēngsù	vitamin
唯独	wéidú	only
为难	wéinán	embarrassed
为期	wéiqī	by a definite date
委托	wěituō	entrust
委员	wěiyuán	committee member
伪造	wěizào	forge
喂（叹）	wèi	hey
未免	wèimiǎn	rather
畏惧	wèijù	fear
卫星	wèixīng	satellite
慰问	wèiwèn	condolences
蔚蓝	wèilán	azure
温带	wēndài	the temperate zone
温和	wēnhé	mild
文凭	wénpíng	diploma
文物	wénwù	cultural relic
文献	wénxiàn	literature
文雅	wényǎ	elegant
文艺	wényì	literature
问世	wènshì	the advent of
窝	wō	nest
乌黑	wūhēi	black
污蔑	wūmiè	slander
诬陷	wūxiàn	framed
无比	wúbǐ	extremely
无偿	wúcháng	for free
无耻	wúchǐ	shameless
无动于衷	wúdòngyúzhōng	completely indifferent
无非	wúfēi	nothing more than
无精打采	wújīngdǎcǎi	be in the blues
无赖	wúlài	rogue
无理取闹	wúlǐqǔnào	make trouble out of nothing
无能为力	wúnéngwéilì	incapable of action
无辜	wúgū	innocent
无穷无尽	wúqióngwújìn	inexhaustible
无微不至	wúwēibúzhì	considerate right down to the most trivial detail
无忧无虑	wúyōuwúlǜ	be light of heart from care
无知	wúzhī	ignorance
舞蹈	wǔdǎo	dance
武器	wǔqì	arms
武侠	wǔxiá	martial arts
武装	wǔzhuāng	armed forces
侮辱	wǔrǔ	insult
务必	wùbì	must
误差	wùchā	error
误解	wùjiě	misunderstand
物业	wùyè	property
物美价廉	wùměijiàlián	high quality and inexpensive
物资	wùzī	goods and materials
溪	xī	brook
膝盖	xīgài	knee
熄灭	xīmiè	crush out; go out
昔日	xīrì	the past
牺牲	xīshēng	sacrifice
夕阳	xīyáng	setting sun
媳妇	xífu	daughter-in-law
习俗	xísú	custom
袭击	xíjī	a surprise attack
喜闻乐见	xǐwénlèjiàn	love to see and hear
喜悦	xǐyuè	joy
系列	xìliè	series
细胞	xìbāo	cells
细菌	xìjūn	bacteria
细致	xìzhì	careful
霞	xiá	rosy clouds
狭隘	xiá'ài	narrow and limited
狭窄	xiázhǎi	narrow
峡谷	xiágǔ	canyon
下属	xiàshǔ	subordinate
先进	xiānjìn	advanced
先前	xiānqián	previously
鲜明	xiānmíng	distinct
掀起	xiānqǐ	set off
纤维	xiānwéi	fibre
弦	xián	string
嫌	xián	dislike and avoid
嫌疑	xiányí	suspicion
闲话	xiánhuà	gossip
贤惠	xiánhuì	virtuous
衔接	xiánjiē	joint
显著	xiǎnzhù	remarkable
现场	xiànchǎng	scene
现成	xiànchéng	ready-made
现状	xiànzhuàng	present situation
宪法	xiànfǎ	constitution
陷害	xiànhài	framed
陷入	xiànrù	fall into
陷阱	xiànjǐng	trap
馅儿	xiànr	filling
线索	xiànsuǒ	clue
相差	xiāngchà	differ
相等	xiāngděng	equal
相辅相成	xiāngfǔxiāngchéng	exist side by side and play a part together
相应	xiāngyìng	corresponding
镶嵌	xiāngqiàn	set, inlay
乡镇	xiāngzhèn	town
想方设法	xiǎngfāngshèfǎ	try various devices to
响亮	xiǎngliàng	loud and clear
响应	xiǎngyìng	response
巷	xiàng	alley
向导	xiàngdǎo	guide
向来	xiànglái	always
向往	xiàngwǎng	yearn for
相声	xiàngsheng	crosstalk
消除	xiāochú	eliminate
消毒	xiāodú	disinfection
消防	xiāofáng	fire control
消耗	xiāohào	consume
消灭	xiāomiè	eliminate
销毁	xiāohuǐ	destroy by melting or burning
小心翼翼	xiǎoxīnyìyì	with great care
效益	xiàoyì	benefit
肖像	xiàoxiàng	portrait
潇洒	xiāosǎ	chic
携带	xiédài	carry
协会	xiéhuì	association
协商	xiéshāng	consult
协调	xiétiáo	coordinate
协议	xiéyì	agreement
协助	xiézhù	assist
屑	xiè	chip
谢绝	xièjué	decline with thanks
泄露	xièlòu	leakage
泄气	xièqì	feel discouraged
新陈代谢	xīnchéndàixiè	the new supersedes the old
新郎	xīnláng	groom
新娘	xīnniáng	bride
新颖	xīnyǐng	novel
心得	xīndé	experience
心灵	xīnlíng	heart
心态	xīntài	mentality
心疼	xīnténg	distressed
心血	xīnxuè	blood
心眼儿	xīnyǎnr	heart, mind, intention
心甘情愿	xīngānqíngyuàn	willingly
辛勤	xīnqín	hardworking
欣慰	xīnwèi	gratified
欣欣向荣	xīnxīnxiàngróng	thriving
薪水	xīnshui	salary
信赖	xìnlài	trust; rely
信念	xìnniàn	belief
信仰	xìnyǎng	faith
信誉	xìnyù	reputation
腥	xīng	fishy
兴隆	xīnglóng	prosperous
兴旺	xīngwàng	prosperous
行政	xíngzhèng	administration
形态	xíngtài	form
刑事	xíngshì	criminal
性感	xìnggǎn	sexy
性命	xìngmìng	life
性能	xìngnéng	performance
兴高采烈	xìnggāocǎiliè	be jubilant
兴致勃勃	xìngzhìbóbó	be in the best of spirits
胸怀	xiōnghuái	mind
胸膛	xiōngtáng	chest
汹涌	xiōngyǒng	turbulent
凶恶	xiōng'è	ferocious
凶手	xiōngshǒu	murderer
雄厚	xiónghòu	abundant
雄伟	xióngwěi	magnificent
修复	xiūfù	repair
修建	xiūjiàn	build
修养	xiūyǎng	training, mastery
羞耻	xiūchǐ	shame
绣	xiù	embroidery
嗅觉	xiùjué	smell
虚假	xūjiǎ	false sham
虚荣	xūróng	vanity
虚伪	xūwěi	hypocrisy
需求	xūqiú	demand
须知	xūzhī	notice
许可	xǔkě	permit
酗酒	xùjiǔ	alcohol
畜牧	xùmù	animal husbandry
序言	xùyán	preface
喧哗	xuānhuá	uproar
宣誓	xuānshì	swear an oath
宣扬	xuānyáng	preach
悬挂	xuánguà	suspension
悬念	xuánniàn	suspense
悬殊	xuánshū	disparity
悬崖峭壁	xuányáqiàobì	steep cliff
旋律	xuánlǜ	melody
旋转	xuánzhuǎn	rotate
选拔	xuǎnbá	selection
选举	xuǎnjǔ	election
选手	xuǎnshǒu	player
炫耀	xuànyào	show off
削	xuē	cut
削弱	xuēruò	weaken; cripple
学说	xuéshuō	theory
学位	xuéwèi	academic degree
雪上加霜	xuěshàngjiāshuāng	one disaster after another
血压	xuèyā	blood pressure
熏陶	xūntáo	the influence of
循环	xúnhuán	loop
循序渐进	xúnxùjiànjìn	follow in order and advance step by step
巡逻	xúnluó	patrol
寻觅	xúnmì	looking for
压迫	yāpò	oppression
压岁钱	yāsuìqián	lucky money in new year
压缩	yāsuō	compress
压抑	yāyì	oppress; overbear
压榨	yāzhà	press
压制	yāzhì	suppress
亚军	yàjūn	runner-up
鸦雀无声	yāquèwúshēng	silent
烟花爆竹	yānhuābàozhú	fireworks and firecrackers
淹没	yānmò	flood
延期	yánqī	delay
延伸	yánshēn	extend
延续	yánxù	continue
严寒	yánhán	severe cold
严禁	yánjìn	strictly prohibit
严峻	yánjùn	stern; serious; harsh
严厉	yánlì	severe
严密	yánmì	tight
沿海	yánhǎi	coastal
言论	yánlùn	speech
炎热	yánrè	scorching hot
岩石	yánshí	rock
演变	yǎnbiàn	evolution
演习	yǎnxí	exercise
演绎	yǎnyì	deduction
演奏	yǎnzòu	play
掩盖	yǎngài	cover up
掩护	yǎnhù	cover
掩饰	yǎnshì	conceal
眼光	yǎnguāng	eye
眼色	yǎnsè	meaningful glance
眼神	yǎnshén	expression in one's eyes
验收	yànshōu	check before acceptance
验证	yànzhèng	verification
厌恶	yànwù	hate
氧气	yǎngqì	oxygen
样品	yàngpǐn	sample
摇摆	yáobǎi	swing
摇滚	yáogǔn	rock
遥控	yáokòng	remote control
遥远	yáoyuǎn	distant
谣言	yáoyán	rumor
要点	yàodiǎn	main points
要命	yàomìng	kill, extremely
要素	yàosù	essential factor
耀眼	yàoyǎn	dazzling
野蛮	yěmán	barbarism
野心	yěxīn	ambition
液体	yètǐ	liquid
一流	yīliú	first-class
依旧	yījiù	still
依据	yījù	basis
依靠	yīkào	rely on; depend on
依赖	yīlài	rely on
依托	yītuō	rely on
衣裳	yīshang	clothes
一度	yídù	once
一贯	yíguàn	consistent
一目了然	yímùliǎorán	stick out a mile
一向	yíxiàng	always
遗产	yíchǎn	heritage
遗传	yíchuán	inheritance
遗留	yíliú	left
遗失	yíshī	loss
疑惑	yíhuò	doubt; disbelieve
仪器	yíqì	instrument
仪式	yíshì	ceremony
以便	yǐbiàn	so that
以免	yǐmiǎn	in case
以往	yǐwǎng	past
以至	yǐzhì	so that; down to
以致	yǐzhì	so that
亦	yì	also
翼	yì	wing
一帆风顺	yìfānfēngshùn	everything is going smoothly
一举两得	yìjǔliǎngdé	shoot two hawks with one arrow
一如既往	yìrújìwǎng	as always
一丝不苟	yìsībùgǒu	be strict in one's demands
异常	yìcháng	abnormal
意料	yìliào	expect; anticipate
意识	yìshí	consciousness
意图	yìtú	intention
意味着	yìwèizhe	signify
意向	yìxiàng	intention
意志	yìzhì	will
毅力	yìlì	will
毅然	yìrán	resolutely; firmly
阴谋	yīnmóu	conspiracy
音响	yīnxiǎng	sound
隐蔽	yǐnbì	concealment
隐患	yǐnhuàn	hidden danger
隐瞒	yǐnmán	hide
隐私	yǐnsī	privacy
隐约	yǐnyuē	vaguely
引导	yǐndǎo	guide
引擎	yǐnqíng	engine
引用	yǐnyòng	quote
饮食	yǐnshí	diet
婴儿	yīng'ér	baby
英明	yīngmíng	wise
英勇	yīngyǒng	heroic
迎面	yíngmiàn	head-on; in one's face
盈利	yínglì	profit
应酬	yìngchou	entertainment
应邀	yìngyāo	invited
拥护	yōnghù	support
拥有	yōngyǒu	have
庸俗	yōngsú	philistine; tacky
勇于	yǒngyú	the courage to
永恒	yǒnghéng	eternal
涌现	yǒngxiàn	the emergence of
踊跃	yǒngyuè	enthusiastically
用户	yònghù	user
优胜劣汰	yōushèngliètài	survival of the fittest
优先	yōuxiān	first
优异	yōuyì	excellent
优越	yōuyuè	superior
忧郁	yōuyù	heavy-hearted
油腻	yóunì	greasy
油漆	yóuqī	paint
犹如	yóurú	like; as if; just as
有条不紊	yǒutiáobùwěn	everything in good order and well arranged
幼稚	yòuzhì	immature
诱惑	yòuhuò	tempt; lure
愚蠢	yúchǔn	stupid
愚昧	yúmèi	foolish
舆论	yúlùn	public opinion
渔民	yúmín	fisherman
与日俱增	yǔrìjùzēng	grow with each passing day
羽绒服	yǔróngfú	down jackets
宇宙	yǔzhòu	universe
愈	yù	more
预料	yùliào	expect
预期	yùqī	expect; anticipate
预算	yùsuàn	budget
预先	yùxiān	beforehand
预言	yùyán	prophesy
预兆	yùzhào	omen
玉	yù	jade
欲望	yùwàng	desire
寓言	yùyán	fable
冤枉	yuānwang	wrong; treat unjustly
元首	yuánshǒu	the heads of a state
元素	yuánsù	element
元宵节	yuánxiāojié	the Lantern Festival
圆满	yuánmǎn	satisfactorily
原告	yuángào	accuser
原理	yuánlǐ	principle
原始	yuánshǐ	original
原先	yuánxiān	original
缘故	yuángù	reason
园林	yuánlín	gardens
源泉	yuánquán	headspring
约束	yuēshù	bind; restrain
乐谱	yuèpǔ	music score
岳母	yuèmǔ	mother in law
熨	yùn	ironing
蕴藏	yùncáng	hold in store; contain
运算	yùnsuàn	operation
运行	yùnxíng	run; working
酝酿	yùnniàng	brewing
孕育	yùnyù	inoculation; breed
砸	zá	hit
杂技	zájì	acrobatics
杂交	zájiāo	hybridization
咋	zǎ	how; why
灾难	zāinàn	disaster
栽培	zāipéi	cultivate
宰	zǎi	slaughter
在意	zàiyì	care about
再接再厉	zàijiēzàilì	make persistent efforts
攒	zǎn	save
赞叹	zàntàn	praise
赞助	zànzhù	sponsor
暂且	zànqiě	for the time being
糟蹋	zāotà	waste; ruin
遭受	zāoshòu	suffer
遭殃	zāoyāng	suffer
遭遇	zāoyù	encounter
造型	zàoxíng	style; modeling
噪音	zàoyīn	noise
责怪	zéguài	blame
贼	zéi	thief
增添	zēngtiān	add
赠送	zèngsòng	give
渣	zhā	residue
扎	zhā	tie
扎实	zhāshi	solid
眨	zhǎ	blink
诈骗	zhàpiàn	fraud
摘要	zhāiyào	abstract
债券	zhàiquàn	bond
沾光	zhānguāng	gain some advantage from another
瞻仰	zhānyǎng	look at with reverence
斩钉截铁	zhǎndīngjiétiě	resolute and decisive
展示	zhǎnshì	exhibit
展望	zhǎnwàng	expectation
展现	zhǎnxiàn	to show
崭新	zhǎnxīn	completely new
战斗	zhàndòu	battle
战略	zhànlüè	strategy
战术	zhànshù	tactics
战役	zhànyì	battle
占据	zhànjù	occupy
占领	zhànlǐng	occupy
章程	zhāngchéng	constitution, regulations
障碍	zhàng'ài	obstacle
帐篷	zhàngpeng	tent
招标	zhāobiāo	call for bids
招收	zhāoshōu	recruit
朝气蓬勃	zhāoqìpéngbó	full of youthful spirit
着迷	zháomí	be fascinated
沼泽	zhǎozé	swamp
照样	zhàoyàng	all the same; as before
照耀	zhàoyào	shine
遮挡	zhēdǎng	keep out
折腾	zhēteng	toss
折	zhé	fracture
折磨	zhémó	torture
真理	zhēnlǐ	truth
真相	zhēnxiàng	fact; truth
真挚	zhēnzhì	sincere
珍贵	zhēnguì	precious
珍稀	zhēnxī	rare
珍珠	zhēnzhū	pearl
侦探	zhēntàn	detective
斟酌	zhēnzhuó	consider
枕头	zhěntou	pillow
阵地	zhèndì	position
阵容	zhènróng	lineup
镇定	zhèndìng	calm
镇静	zhènjìng	calm
振奋	zhènfèn	exciting
振兴	zhènxīng	the revitalization of
震撼	zhènhàn	shock
震惊	zhènjīng	shock
争端	zhēngduān	dispute
争夺	zhēngduó	fight for
争气	zhēngqì	try to win credit for
争先恐后	zhēngxiānkǒnghòu	strive to be the first; vie with each other
争议	zhēngyì	dispute
蒸发	zhēngfā	evaporation
征服	zhēngfú	conquer
征收	zhēngshōu	collection
正月	zhēngyuè	January (moon calendar)
挣扎	zhēngzhá	struggle
整顿	zhěngdùn	rectify
正当	zhèngdāng	proper
正负	zhèngfù	positive and negative
正规	zhèngguī	regular
正经	zhèngjing	serious
正气	zhèngqì	righteousness
正义	zhèngyì	justice
正宗	zhèngzōng	authentic
政策	zhèngcè	policy
政权	zhèngquán	regime
证实	zhèngshí	confirm
证书	zhèngshū	certificate
郑重	zhèngzhòng	solemnly
症状	zhèngzhuàng	symptom
之际	zhī jì	it's time…
枝	zhī	branch
支撑	zhīchēng	brace
支出	zhīchū	payout; expend
支流	zhīliú	tributary
支配	zhīpèi	control
支援	zhīyuán	support
支柱	zhīzhù	mainstay; backbone
知觉	zhījué	perception
知足常乐	zhīzúchánglè	happy is he who is content
脂肪	zhīfáng	fat
直播	zhíbō	on live
直径	zhíjìng	diameter
值班	zhíbān	be on duty
殖民地	zhímíndì	colony
职能	zhínéng	function
职位	zhíwèi	position
职务	zhíwù	post
执行	zhíxíng	implement
执着	zhízhuó	persistent
侄子	zhízi	nephew
指标	zhǐbiāo	index
指定	zhǐdìng	appoint
指甲	zhǐjia	nail
指令	zhǐlìng	instructions
指南针	zhǐnánzhēn	compass
指示	zhǐshì	instructions
指望	zhǐwàng	expect; figure on
指责	zhǐzé	accuse
治安	zhì'ān	public security
治理	zhìlǐ	government
制裁	zhìcái	sanction
制服	zhìfú	uniform
制约	zhìyuē	restrict
制止	zhìzhǐ	stop it
致辞	zhìcí	speech
致力	zhìlì	devote oneself to
致使	zhìshǐ	cause
智力	zhìlì	intelligence
智能	zhìnéng	intelligence
智商	zhìshāng	intelligence quotient
滞留	zhìliú	retention
志气	zhìqì	ambition
忠诚	zhōngchéng	loyal
忠实	zhōngshí	faithful
终点	zhōngdiǎn	end
终究	zhōngjiū	after all
终身	zhōngshēn	lifelong
终止	zhōngzhǐ	termination
中断	zhōngduàn	interrupt
中立	zhōnglì	neutral
中央	zhōngyāng	center
衷心	zhōngxīn	heartfelt
种子	zhǒngzi	seed
种族	zhǒngzú	race
种植	zhòngzhí	plant
肿瘤	zhǒngliú	tumour
重心	zhòngxīn	focus
众所周知	zhòngsuǒzhōuzhī	as everyone knows
州	zhōu	state
舟	zhōu	boat
粥	zhōu	porridge
周边	zhōubiān	periphery
周密	zhōumì	thorough; careful
周年	zhōunián	anniversary
周期	zhōuqī	period cycle
周折	zhōuzhé	twists and turns
周转	zhōuzhuǎn	turnover
皱纹	zhòuwén	wrinkle
昼夜	zhòuyè	day and night
株	zhū	plant (measure word)
诸位	zhūwèi	every one
逐年	zhúnián	year by year
拄	zhǔ	lean on a stick
主办	zhǔbàn	host
主导	zhǔdǎo	leading
主管	zhǔguǎn	executive director
主流	zhǔliú	main stream
主权	zhǔquán	sovereignty
主义	zhǔyì	doctrine
嘱咐	zhǔfù	charge someone with a task
住宅	zhùzhái	residence
注射	zhùshè	injection
注视	zhùshì	gaze
注释	zhùshì	note; annotation
注重	zhùzhòng	pay attention to
助理	zhùlǐ	assistant
助手	zhùshǒu	assistant
著作	zhùzuò	work
驻扎	zhùzhā	be stationed
铸造	zhùzào	casting, foundry
拽	zhuài	drag; haul
专长	zhuāncháng	expertise
专程	zhuānchéng	special-purpose trip
专利	zhuānlì	patent
专题	zhuāntí	special collection
砖	zhuān	brick
转达	zhuǎndá	convey
转让	zhuǎnràng	make over; transfer
转移	zhuǎnyí	transfer
转折	zhuǎnzhé	transition
传记	zhuànjì	biography
装备	zhuāngbèi	equipment
装卸	zhuāngxiè	loading and unloading
庄严	zhuāngyán	solemn
庄重	zhuāngzhòng	grand; superb
庄稼	zhuāngjia	crops
幢	zhuàng	building (meaure word)
壮观	zhuàngguān	grand; sublime
壮丽	zhuànglì	magnificent
壮烈	zhuàngliè	brave; heroic
追悼	zhuīdào	mour for
追究	zhuījiū	investigate
坠	zhuì	fall
准则	zhǔnzé	criterion
琢磨	zhuómó	pondering
着手	zhuóshǒu	to start
着想	zhuóxiǎng	consider
着重	zhuózhòng	emphasize
卓越	zhuóyuè	excellent
资本	zīběn	capital
资产	zīchǎn	capital; asset
资深	zīshēn	senior
资助	zīzhù	give financial aid
姿态	zītài	attitude
滋味	zīwèi	taste
滋润	zīrùn	moisturize
子弹	zǐdàn	bullet
自卑	zìbēi	inferiority
自发	zìfā	spontaneous; unprompted
自力更生	zìlìgēngshēng	rely through one's own efforts
自满	zìmǎn	complacent
自主	zìzhǔ	autonomy
踪迹	zōngjì	tail; trail; trace
宗教	zōngjiào	religion
宗旨	zōngzhǐ	purpose
棕色	zōngsè	brown
总而言之	zǒng'éryánzhī	to make a long story short
总和	zǒnghé	summation
纵横	zònghéng	in length and breadth
走廊	zǒuláng	corridor
走漏	zǒulòu	leak out
走私	zǒusī	smuggle
揍	zòu	beat
租赁	zūlìn	lease
足以	zúyǐ	enough
阻碍	zǔ'ài	hinder
阻拦	zǔlán	block off
阻挠	zǔnáo	obstruct; stand in the way
祖父	zǔfù	grandfather
祖国	zǔguó	motherland
祖先	zǔxiān	ancestors
钻研	zuānyán	study intensively
钻石	zuànshí	diamonds
嘴唇	zuǐchún	lips
罪犯	zuìfàn	criminal
尊严	zūnyán	dignity
遵循	zūnxún	follow
做主	zuòzhǔ	decide
座右铭	zuòyòumíng	motto
作弊	zuòbì	cheat
作废	zuòfèi	cancel, blank out
作风	zuòfēng	style
作息	zuòxī	work and rest