我	wǒ	I, me
我们	wǒmen	we, us (pl.)
你	nǐ	you
他	tā	he, him
她	tā	she, her
这 (这儿)	zhè ( zhèr)	this (here)
那 (那儿)	nà (nàr)	that (there)
哪	nǎ	which
哪儿	nǎr	where
谁	shéi	who
什么	shénme	what, why
多少	duōshǎo	how many, how much
几	jǐ	a few, how many
怎么	zěnme	how
怎么样	zěnmeyàng	how about
一	yī	one
二	èr	two
三	sān	three
四	sì	four
五	wǔ	five
六	liù	six
七	qī	seven
八	bā	eight
九	jiǔ	nine
十	shí	ten
个	gè	(for normal objects)
岁	suì	(for age)
本	běn	(for books)
些	xiē	some
块	kuài	piece, chunk
不	bù	no
没	méi	no
很	hěn	quite, very
太	tài	too
都	dōu	all
一点儿	yīdiǎnr	a little bit
和	hé	and
在	zài	in, at
的	de	of; ~'s (possessive particle)
了	le	past tense marker
吗	ma	(question particle for "yes-no" questions)
呢	ne	particle indicating that a previously asked question is to be applied to the preceding word
喂	wèi	hello
家	jiā	home
学校	xuéxiào	school
饭店	fàndiàn	restaurant
商店	shāngdiàn	store
医院	yīyuàn	hospital
中国	zhōngguó	China
北京	běijīng	Beijing
上	shàng	up
下	xià	down
前面	qiánmiàn	front
后面	hòumiàn	behind
里面	lǐmiàn	inside
今天	jīntiān	today
明天	míngtiān	tomorrow
昨天	zuótiān	yesterday
上午	shàngwǔ	morning
中午	zhōngwǔ	noon
下午	xiàwǔ	afternoon
年	nián	year
月	yuè	month
号	hào	number/date
星期	xīngqī	week
点	diǎn	o'clock
分钟	fēnzhōng	minute
现在	xiànzài	now
时候	shíhou	time
爸爸	bàba	father
妈妈	māma	mother
儿子	érzi	son
女儿	nǚ'ér	daughter
老师	lǎoshī	teacher
学生	xuéshēng	student
同学	tóngxué	classmate
朋友	péngyǒu	friend
医生	yīshēng	doctor
先生	xiānsheng	sir
小姐	xiǎojiě	Miss
衣服	yīfu	cloth
水	shuǐ	water
菜	cài	dish
米饭	mǐfàn	rice
水果	shuǐguǒ	fruit
苹果	píngguǒ	apple
茶	chá	tea
杯子	bēizi	cup
钱	qián	money
飞机	fēijī	airplane
出租车	chūzūchē	taxi
电视	diànshì	television
电脑	diànnǎo	computer
电影	diànyǐng	movie
天气	tiānqì	weather
猫	māo	cat
狗	gǒu	dog
东西	dōngxi	thing
人	rén	person
名字	míngzi	name
书	shū	book
汉语	hànyǔ	Mandarin Chinese
字	zì	character
桌子	zhuōzi	desk
椅子	yǐzi	chair
谢谢	xièxie	thank
不客气	búkèqì	you're welcome
再见	zàijiàn	good-bye
请	qǐng	please
对不起	duìbuqǐ	I'm sorry
没关系	méiguānxi	it doesn't matter
是	shì	be (am, is, are)
有	yǒu	have
看	kàn	look
听	tīng	listen
说	shuō	speak
读	dú	read
写	xiě	write
看见	kànjiàn	see
叫	jiào	call
来	lái	come
回	huí	return
去	qù	go
吃	chī	eat
喝	hē	drink
睡觉	shuìjiào	sleep
打电话	dǎ diànhuà	make phone call
做	zuò	do
买	mǎi	buy
开	kāi	open
坐	zuò	sit
住	zhù	live
学习	xuéxí	study
工作	gōngzuò	work
下雨	xiàyǔ	rain
爱	ài	love
喜欢	xǐhuān	love, like
想	xiǎng	want
认识	rènshi	know
会	huì	can
能	néng	can, be able to
好	hǎo	good
大	dà	big
小	xiǎo	small
多	duō	many, much
少	shǎo	few, little
冷	lěng	cold
热	rè	hot
高兴	gāoxìng	happy
漂亮	piàoliang	beautiful