阿姨	āyí	aunt
啊	a	ah
矮	ǎi	short
矮小	ǎi xiǎo	short and small; low and small; undersized
爱国	ài guó	love one's country; be patriotic
爱护	àihù	care
安	ān	quiet; safe; secure; install; fix; fit
安置	ānzhì	put; arrange for
按时	ànshí	on time
暗	àn	dark
暗示	ànshì	suggest secretly
巴士	bā shì	bus
百货	bǎi huò	department store; general merchandise
摆	bǎi	pendulum
摆动	bǎi dòng	swing; sway; oscillate;vibrate
摆脱	bǎituō	cast off
败	bài	defeat; beat; fail; lose
办事	bàn shì	handle affairs; work
包裹	bāoguǒ	package
包含	bāohán	contain
包括	bāokuò	include
薄	báo	thin
宝	bǎo	treasure; precious; treasured
宝宝	bǎo bao	baby; darling
宝贝	bǎobèi	baby
宝贵	bǎoguì	valuable
宝石	bǎo shí	gemstone; gem; cameo; precious stone
保密	bǎomì	secrecy
保守	bǎoshǒu	conservative
抱	bào	hold, hug
背景	bèijǐng	background
倍	bèi	times
被迫	bèi pò	be compelled; be forced; be constrained
本科	běnkē	undergraduate
笨	bèn	stupid
比分	bǐ fēn	score
毕业	bìyè	graduation
毕业生	bì yè shēng	graduate
避	bì	avoid; evade; dodge; keep away; repel
避免	bìmiǎn	avoid
编	biān	invent; make up; plait; edit; compile; compose; write
辩论	biànlùn	debate
标志	biāozhì	sign
表情	biǎoqíng	expression
表扬	biǎoyáng	praise
别（动）	bié	do not; leave; separate; pin
冰	bīng	ice
冰箱	bīngxiāng	refrigerator
冰雪	bīng xuě	ice and snow
兵	bīng	arms; soldier; force; weapon; military
并（动）	bìng	combine; merge; incorporate
不要紧	búyàojǐn	never mind
不在乎	bú zài hū	not mind; not care
不管	bùguǎn	no matter
不然	bùrán	otherwise
布置	bùzhì	arrangement
步行	bù xíng	go on foot; walk
擦	cā	wipe
才（名）	cái	ability; talent; gift; endowment
材料	cáiliào	materials
财产	cáichǎn	property
财富	cáifù	wealth
采访	cǎifǎng	interview
参考	cānkǎo	reference resources
参与	cānyù	participate in
操场	cāochǎng	playground
操作	cāozuò	operation
测	cè	survey; fathom; measure; conjecture; infer
测量	cèliáng	measure
测试	cè shì	test; examination
曾	céng	once; already; at some time in the past
茶叶	chá yè	tea; tea-leaves
产品	chǎnpǐn	product
长途	chángtú	long-distance
常识	chángshí	common sense
唱片	chàng piàn	record; disc; phonogram
抄	chāo	copy
抄写	chāo xiě	copy; transcribe
潮	cháo	moist; damp; humid; tide
潮流	cháoliú	trend
潮湿	cháoshī	damp
彻底	chèdǐ	thorough
沉	chén	sink; keep down; lower; deep; profound; heavy
沉默	chénmò	silent
沉重	chénzhòng	heavy
称赞	chēngzàn	praise
成人	chéngrén	adult
诚实	chéngshí	honest
诚信	chéng xìn	honesty; integrity
承担	chéngdān	bear
承认	chéngrèn	admit
承受	chéngshòu	bear
程序	chéngxù	program
吃惊	chījīng	be amazed
迟到	chídào	late
尺	chǐ	rule; ruler
尺寸	chǐ cùn	size; measurement; dimension
尺子	chǐzi	ruler
冲	chōng	punching
充电	chōng diàn	recharge; charge
充电器	chōngdiànqì	charger
充分	chōngfèn	to the full
虫子	chóng zi	insect; worm; bug
抽	chōu	pump; take out; shrink; pick out
抽奖	chōu jiǎng	lottery; lottery draw
抽烟	chōuyān	smoking
出口	chūkǒu	exit
出色	chūsè	excellent; outstanding
出售	chū shòu	offer for sale; sell
出席	chūxí	attend
处于	chǔ yú	be in; be (in a certain condition)
处	chǔ	dwell; live; be in a position of
穿上	chuān shàng	put on
传统	chuántǒng	tradition
窗户	chuānghu	window
窗台	chuāng tái	windowsill; sill
窗子	chuāng zi	window
春季	chūn jì	spring; springtime
纯	chún	pure; unmixed; simple; skilful; practised
纯净水	chún jìng shuǐ	pure water
词汇	cíhuì	vocabulary
此	cǐ	this; these; now; here
此外	cǐwài	in addition
次（形）	cì	second-rate; secondary
刺	cì	thorn
刺激	cìjī	stimulate
从此	cóngcǐ	from then on
粗	cū	wide; thick; coarse; rough; gruff; careless; rude
粗心	cūxīn	careless
促进	cùjìn	promote
促使	cùshǐ	urge
促销	cù xiāo	promotion
措施	cuòshī	measures
打	dǎ	strike; hit; break; fight; build; beat
答案	dá'àn	answer
打败	dǎ bài	defeat; beat; be defeated
打雷	dǎ léi	thunder
打扫	dǎsǎo	clean
打折	dǎzhé	discount
打针	dǎzhēn	to make an injection
大巴	dà bā	bus
大多	dà duō	mostly; for the most part
大方	dàfang	generous
大哥	dà gē	big brother; elder brother
大规模	dà guī mó	large-scale; extensive
大会	dà huì	convention; general meeting; General Assembly
大姐	dà jiě	elder sister
大楼	dà lóu	building; large building
大陆	dà lù	continent; mainland
大妈	dà mā	aunt; father's elder brother's wife
大型	dàxíng	large
大爷	dà ye	uncle; father's elder brother
大众	dà zhòng	public; the masses; people
代替	dàitì	replace
待遇	dàiyù	treatment
袋	dài	bag; sack; pocket; pouch
戴	dài	wear
担保	dānbǎo	assure; hypothecate
担任	dānrèn	to serve as
担心	dānxīn	worry
单	dān	single; odd; unlined; thin; weak; only; alone
单纯	dānchún	simple
单调	dāndiào	monotonous
单独	dāndú	alone
淡	dàn	light
导游	dǎoyóu	guide
导致	dǎozhì	cause
倒闭	dǎobì	collapse
倒车	dǎo chē	change trains or buses
倒车	dào chē	back a car; reverse
得意	déyì	proud
得	děi	need; must; have to; be sure to
灯光	dēng guāng	light; stage lighting
登	dēng	ascend; mount; scale; step on; pedal; publish
登记	dēngjì	register
登录	dēnglù	sign in
登山	dēng shān	mountaineer; mountain-climbing
的确	díquè	indeed; be certain to
敌人	dírén	enemy
底	dǐ	bottom
地方	dìfang	local
地面	dì miàn	ground; floor; surface
地位	dìwèi	status
地下	dì xià	underground; subterranean; secret
地址	dìzhǐ	address
典型	diǎnxíng	typical
点名	diǎn míng	rollcall; mention sb. by name
电灯	diàn dēng	electric light
电动车	diàn dòng chē	electric car
电梯	diàntī	elevator
电源	diànyuán	power supply
顶	dǐng	top
定	dìng	decide; fix; book; order; calm; stable
冬季	dōng jì	winter
动画片	dònghuàpiàn	cartoon
动摇	dòng yáo	shake; vacillate; waver; be indecisive
豆腐	dòufu	tofu
独立	dúlì	independent
独特	dútè	unique
独自	dú zì	alone; by oneself; one's own
堵	dǔ	stop up; block up; stifled; suffocated; oppressed
堵车	dǔchē	traffic jam
肚子	dùzi	belly
度过	dùguò	spend
锻炼	duànliàn	physical exercise
对比	duìbǐ	contrast
对付	duìfu	deal with
对于	duìyú	about
多次	duō cì	repeatedly; many a time
多年	duō nián	many years
多样	duō yàng	diversity
多种	duō zhǒng	multiple; various; diversified; manifold
恶心	ěxin	disgusting
儿童	értóng	children
而	ér	and
而是	ér shì	but
耳机	ěr jī	earphone; headphone; headset
二手	èr shǒu	second hand
发挥	fāhuī	develop
发票	fāpiào	invoice
发烧	fāshāo	have a fever
法	fǎ	law; way; method; example; rule
法官	fǎ guān	judge
法律	fǎlǜ	law
法院	fǎyuàn	court
翻	fān	turn
翻译	fānyì	translate
烦	fán	bother; to bother
反	fǎn	turn over; rebel; on the contrary; instead
反而	fǎn'ér	instead
反映	fǎnyìng	reflect
方	fāng	square
方案	fāng'àn	programme
方针	fāngzhēn	policy
放松	fàngsōng	relax
非	fēi	wrong
肥	féi	fat; fertile
分布	fēnbù	distribution
分散	fēnsàn	dispersed
分手	fēnshǒu	break up
分为	fēn wéi	divide into
…分之…	… fēn zhī …	fractional number
纷纷	fēnfēn	one after another
奋斗	fèndòu	struggle
风格	fēnggé	style
风景	fēngjǐng	scenery
风俗	fēngsú	customs
封闭	fēngbì	close
否则	fǒuzé	otherwise
夫妇	fūfù	couple
夫妻	fū qī	man and wife
夫人	fūrén	madam
符号	fúhào	symbol
符合	fúhé	accord with
付出	fù chū	pay out
负担	fùdān	burden
附近	fùjìn	nearby
复制	fùzhì	copy
改善	gǎishàn	improve
改正	gǎizhèng	correction
盖	gài	cover
概括	gàikuò	generalization
感兴趣	gǎnxìngqù	be intretested in
高潮	gāocháo	climax
高价	gāo jià	high price
高尚	gāoshàng	noble
高铁	gāo tiě	high-speed train; high-speed rail
格外	géwài	especially
隔	gé	partition; separate; divide
隔开	gé kāi	separate; space out; separation; partition
个别	gèbié	individual
个体	gètǐ	individual
各个	gè gè	each
根	gēn	root
根据	gēnjù	according to
工程	gōng chéng	engineering; project
公元	gōngyuán	A.D.
供应	gōng yìng	supply; provide
共	gòng	common; general; share; together; altogether
构成	gòuchéng	constitute
构造	gòu zào	structure; construction
购买	gòu mǎi	buy; purchase
购物	gòuwù	shopping
骨头	gǔtou	bone
固定	gùdìng	fixed
瓜	guā	melon
怪（形、副）	guài	strange; odd; bewildering; very; quite; rather
关（名）	guān	pass; check point; customhouse; mechanism; barrier
关闭	guānbì	close; shut
关于	guānyú	about
官	guān	officer
官方	guānfāng	by the government official
光临	guānglín	presence
光盘	guāngpán	CD
逛	guàng	stroll
归	guī	return; go back
规律	guīlǜ	law
规模	guīmó	scale
规则	guīzé	rule
果实	guǒshí	fruit
过分	guòfèn	excessive
海水	hǎi shuǐ	seawater; brine; sea
海鲜	hǎixiān	seafood
含	hán	contain; cherish; nurse; keep
含量	hán liàng	content
含义	hányì	signification; meanings
含有	hán yǒu	contain; have
寒假	hánjià	winter vacation
寒冷	hán lěng	cold; frigid; chill; frigidity
行业	hángyè	industry
航班	hángbān	flight
航空	hángkōng	aviation
毫米	háomǐ	millimeter
毫升	háo shēng	milliliter
好友	hǎo yǒu	friend
号码	hàomǎ	number
好	hǎo	good
合同	hétong	contract
黑暗	hēi àn	dark; darkness; murk
红包	hóng bāo	red envelope; red packet
后头	hòu tou	back
厚	hòu	thick
呼吸	hūxī	breathing
忽视	hūshì	ignore
户	hù	household; family; door
护士	hùshi	nurse
花（形）	huā	multicolored; colored; flowery
划	huá	paddle, row
划	huà	transfer, assign, differentiate
怀念	huáiniàn	miss
怀疑	huáiyí	doubt
缓解	huǎnjiě	relieve
黄瓜	huáng guā	cucumber; cuke
黄金	huángjīn	gold
回复	huí fù	reply
汇	huì	remit; converge; collection; collected things
汇报	huìbào	report
汇率	huìlǜ	exchange rate
婚礼	hūnlǐ	wedding
火（形）	huǒ	fiery; flaming; urgent
伙	huǒ	partner; partnership
伙伴	huǒbàn	partner
或许	huòxǔ	maybe; probably
货	huò	goods; commodity; money
获	huò	obtain; win; reap; capture; catch
获得	huòdé	get
获奖	huò jiǎng	win a prize; receive an award
获取	huò qǔ	gain; obtain
几乎	jīhū	almost
机构	jīgòu	mechanism
机遇	jīyù	opportunity
积累	jīlěi	accumulation
激动	jīdòng	excited
激烈	jīliè	fierce
及格	jígé	pass
极	jí	extremely
极其	jíqí	extremely
即将	jíjiāng	soon
急忙	jímáng	hastily
集合	jíhé	aggregate
记载	jìzǎi	record
纪律	jìlǜ	discipline
技巧	jìqiǎo	skill
系	xì	department
季	jì	season; period
季度	jìdù	quarter (of a year)
季节	jìjié	season
既	jì	already; since; as
既然	jìrán	since
寄	jì	send
加班	jiābān	overtime work
加入	jiā rù	add; mix; join; become a member
加油站	jiāyóuzhàn	gas station
家务	jiāwù	housework
假如	jiǎrú	if
坚固	jiāngù	strong
检测	jiǎn cè	detect; test
减	jiǎn	subtract; reduce; decrease; cut; minus
减肥	jiǎnféi	reduce weight
减少	jiǎnshǎo	reduce
简历	jiǎnlì	resume
健身	jiànshēn	workout
渐渐	jiàn jiàn	gradually; step by step
江	jiāng	river
讲究	jiǎngjiu	pay attention to, stress
讲座	jiǎngzuò	lecture
奖	jiǎng	award; prize; reward
奖金	jiǎngjīn	bonus
奖学金	jiǎng xué jīn	scholarship; fellowship
降	jiàng	fall; drop; descend; come down; lower
降低	jiàngdī	reduce
降价	jiàng jià	cut price; reduce price
降落	jiàngluò	land
降温	jiàng wēn	lower the temperature; drop in temperature
交换	jiāohuàn	exchange
交际	jiāojì	communication
教授	jiàoshòu	professor
教训	jiàoxùn	lesson
阶段	jiēduàn	stage
街道	jiēdào	street
节省	jiéshěng	save
结	jié	bear; form; knit; knot
结构	jiégòu	structure
结论	jiélùn	conclusion
姐妹	jiě mèi	sisters
解释	jiěshì	explain
尽快	jǐnkuài	as soon as possible
紧密	jǐn mì	close; inseparable
尽力	jìnlì	try the best
进口	jìnkǒu	imported
近代	jìndài	modern
禁止	jìnzhǐ	prohibit
经典	jīngdiǎn	classics; scriptures
精力	jīnglì	energy
竟然	jìngrán	unexpectedly
镜头	jìngtóu	camera lens
镜子	jìngzi	mirror
究竟	jiūjìng	exactly
酒吧	jiǔbā	bar
居民	jūmín	residents
居住	jūzhù	live
局（名）	jú	bureau; part; portion; innings; gathering
巨大	jùdà	huge
具备	jùbèi	have, possess
距离	jùlí	distance
聚	jù	assemble; gather; get together
聚会	jùhuì	party
卷	juǎn	roll, curly, reel
卷	juàn	volume; file
角色	juésè	role
开花	kāi huā	flower; bloom; blossom
开水	kāishuǐ	boiling water
看不起	kànbuqǐ	despise
看来	kàn lái	it seems; it appears
看望	kànwàng	visit
考察	kǎochá	investigate
考虑	kǎolǜ	consider
棵	kē	tree (measure word)
可见	kějiàn	so
空间	kōngjiān	space
空	kōng	empty
口袋	kǒu dài	pocket
口语	kǒu yǔ	spoken language
苦	kǔ	bitter
会计	kuàijì	accountant
快递	kuài dì	express delivery
宽	kuān	wide
宽广	kuān guǎng	broad; vast; extensive
矿泉水	kuàngquánshuǐ	mineral water
扩大	kuòdà	expand
扩展	kuò zhǎn	expand; extend; spread; develop
括号	kuò hào	brackets; parentheses
垃圾	lā jī	rubbish; garbage; refuse; waste
拉开	lā kāi	pull open; undraw; zip
辣	là	hot, spicy
来不及	láibují	there's not enough time
来得及	láidejí	in time
来源	láiyuán	source
老公	lǎo gōng	husband
老家	lǎo jiā	hometown; home state
老婆	lǎopó	wife
老实	lǎoshi	honest
乐趣	lèqù	pleasure
泪	lèi	tear; teardrop
泪水	lèi shuǐ	tear; teardrop
类型	lèixíng	type
冷静	lěngjìng	calm down
厘米	límǐ	centimeter
离不开	lí bù kāi	can't do without
力气	lìqi	strength
历史	lìshǐ	history
立即	lìjí	immediately
利息	lìxī	accrual; interest
利益	lìyì	interest
俩	liǎ	two
良好	liánghǎo	good
量	liáng	measure; estimate; amount
粮食	liángshi	foodstuff
两边	liǎng biān	both sides
疗养	liáo yǎng	recuperate; convalesce
了不起	liǎobuqǐ	amazing
了解	liǎojiě	understand
列	liè	arrange; line up; list
列车	lièchē	train
列入	liè rù	included in
列为	liè wéi	be classified as; listed as
临时	línshí	temporary
零食	língshí	snacks
流传	liúchuán	spread
楼梯	lóu tī	stairs; staircase; stairway
陆地	lùdì	land
陆续	lùxù	one after another
录取	lùqǔ	matriculate
律师	lǜshī	lawyer
轮	lún	wheel; ring; take turns
轮船	lúnchuán	ship
轮椅	lún yǐ	wheelchair
轮子	lún zi	wheel
论文	lùnwén	paper
落	luò	fall; drop; go down; set; decline; drop behind
毛巾	máojīn	towel
毛衣	máo yī	sweater; wool sweater
帽子	màozi	hat
没错	méi cuò	that's right
没法儿	méi fǎr	can not; no way
没想到	méi xiǎng dào	didn't expect
美金	měi jīn	USD; dollar
美女	měi nǚ	belle ; beauty; beautiful woman
梦	mèng	dream
梦见	mèng jiàn	see in a dream; dream about; dream
梦想	mèngxiǎng	dream
秘密	mìmì	secret
秘书	mìshū	secretary
密	mì	thick; secret; close; dense
密码	mìmǎ	password
密切	mìqiè	close
免费	miǎnfèi	free of charge
面临	miànlín	face
面试	miàn shì	interview; audition
描述	miáo shù	describe; depict; description
描写	miáoxiě	describe
名牌儿	míng páir	famous brand
名片	míngpiàn	business card
名人	míng rén	celebrity; famous person
摸	mō	feel
模特儿	mó tèr	model
模型	móxíng	model
末	mò	end; last; final stage
默默	mòmò	silently
哪怕	nǎpà	even if
哪	nǎ	which
男女	nán nǚ	men and women; male and female
男士	nán shì	man
难免	nánmiǎn	unavoidable
脑袋	nǎodai	head
闹	nào	noisy; make a noise; suffer; be troubled
闹钟	nào zhōng	alarm clock
内部	nèibù	interior
内科	nèikē	internal medicine
能干	nénggàn	capable
宁静	níng jìng	peaceful; tranquil; quiet
浓	nóng	strong
女士	nǚshì	ma'am
暖气	nuǎn qì	central heating; heating; heater
拍照	pāi zhào	take a picture; photograph
排列	páiliè	array
牌	pái	brand; cards; plate; tablet
盘（名、量）	pán	tray; plate; dish; current price; game; set; (measure word)
盘子	pánzi	plate
胖子	pàng zi	fat person; fatty
培训	péixùn	train
培训班	péi xùn bān	training class
培养	péiyǎng	culture
培育	péiyù	cultivation
批（动）	pī	criticize; batch
批（量）	pī	(measure word)
片面	piànmiàn	one-sided
品质	pǐnzhì	quality
平方	píngfāng	square
平静	píngjìng	calm
平均	píngjūn	average
平稳	píng wěn	smooth; steady
迫切	pòqiè	urgent
破产	pòchǎn	bankruptcy
妻子	qīzi	wife
期待	qīdài	expect; look forward to
期间	qījiān	period
期末	qī mò	end of term
期限	qīxiàn	term
期中	qī zhōng	midterm
其余	qíyú	rest
企业	qǐyè	enterprise
气球	qì qiú	balloon
汽水	qì shuǐ	soda; soda water; aerated water; sparkling water
汽油	qìyóu	gasoline
器官	qìguān	organ
前头	qián tou	front; thereinbefore
前途	qiántú	future
浅	qiǎn	shallow
巧克力	qiǎokèlì	chocolates
切	qiē	cut
亲爱	qīn'ài	dear
亲密	qīnmì	close
青春	qīngchūn	youth
轻松	qīngsōng	relaxed
轻易	qīngyì	easily
清醒	qīngxǐng	sober
情景	qíngjǐng	scene
穷	qióng	poor
穷人	qióng rén	poor people; the poor
秋季	qiū jì	autumn; fall
趋势	qūshì	trend
圈	quān	circle
权利	quánlì	right
却	què	but
确认	quèrèn	confirm
然而	rán'ér	however
燃料	rán liào	fuel
燃烧	ránshāo	burning
热闹	rènao	lively
热心	rèxīn	enthusiastic
人家	rénjiā	family
日记	rìjì	diary
日历	rìlì	calendar
如今	rújīn	nowadays
弱	ruò	weak
伞	sǎn	umbrella
散	sàn	break up; disperse; distribute; disseminate; give out
扫	sǎo	sweep; broom
色	sè	color; look; expression; scene; quality
色彩	sècǎi	color
森林	sēnlín	forest
晒	shài	the sun
闪	shǎn	dodge; get out of the way; sprain; flash; sparkle; shine; lightning
闪电	shǎndiàn	lightning
善良	shànliáng	kind; virtuous
善于	shànyú	be good at
伤害	shānghài	hurt
商务	shāngwù	business
赏	shǎng	award; appreciate; reward
上个月	shàng gè yuè	last month
上楼	shàng lóu	go upstairs
上门	shàng mén	drop in; visit
烧	shāo	burn; cook; bake; roast; run a fever
设施	shèshī	facilities
设置	shèzhì	set up
申请	shēnqǐng	apply
身材	shēncái	figure
身份	shēnfèn	identity
身高	shēn gāo	height
深厚	shēn hòu	deep; profound; solid; deep-seated
神话	shénhuà	myth
神秘	shénmì	mysterious
甚至	shènzhì	even to the extent that
失败	shībài	fail
失望	shīwàng	disappointment
失业	shīyè	unemployment
诗	shī	poetry
诗人	shī rén	poet
湿	shī	wet; damp; humid
实施	shíshī	implementation
实用	shíyòng	practical
食堂	shí táng	dining room; mess hall; canteen
使劲	shǐ jìn	exert all one's strength; put in energy
士兵	shìbīng	soldiers
市区	shì qū	downtown area; urban district
似的	shìde	like
事物	shìwù	thing
事先	shìxiān	prior
试卷	shìjuàn	test paper
是否	shìfǒu	whether
收回	shōu huí	withdraw; regain; call in; countermand
收获	shōuhuò	harvest
收益	shōuyì	income; profit
手工	shǒugōng	manual
手里	shǒu lǐ	in one's hands
手术	shǒushù	operation
手套	shǒutào	glove
守	shǒu	guard; defend; observe
首（量）	shǒu	(measure word)
受不了	shòubuliǎo	cannot bear sth
售货员	shòuhuòyuán	salesperson
叔叔	shūshu	uncle
舒适	shūshì	comfortable
熟练	shúliàn	skilled
暑假	shǔ jià	summer vacation
树林	shù lín	wood; grove; forest
树叶	shù yè	leaf; tree leaf
数据	shùjù	data
数码	shùmǎ	digital
刷	shuā	brush; scrub; paste up
刷牙	shuāyá	brush one's teeth
刷子	shuā zi	brush; scrub
帅	shuài	handsome
帅哥	shuài gē	handsome boy
率先	shuài xiān	lead; take the lead
睡着	shuì zháo	sleep; fall asleep
顺序	shùnxù	order
说不定	shuōbudìng	maybe
说服	shuōfú	persuade
思考	sīkǎo	reflection
似乎	sìhū	it seems that
松	sōng	pine; loose; slack; loosen; relax; slacken
松树	sōng shù	pine tree; pine
塑料	sù liào	plastic
塑料袋	sùliàodài	plastic bag
酸	suān	acid
酸奶	suān nǎi	yogurt
随手	suíshǒu	readily
孙女	sūn nǚ	granddaughter
孙子	sūnzi	grandson
缩短	suōduǎn	shorten
缩小	suō xiǎo	reduce; lessen; narrow; shrink; zoom out
台阶	táijiē	steps
台上	tái shàng	on the stage
躺	tǎng	lie
套餐	tào cān	set meal
特价	tè jià	special offer; bargain price
特殊	tèshū	special
特征	tèzhēng	features
提供	tígōng	provide
提醒	tíxǐng	remind
体操	tǐ cāo	gymnastics
体检	tǐ jiǎn	physical examination
体重	tǐ zhòng	body weight
替	tì	replace; substitute; take the place of; for; on behalf of
替代	tì dài	replace; substitute
天真	tiānzhēn	naive
填	tián	fill; stuff; fill in; write
填空	tiánkòng	fill in the blanks
挑	tiāo	choose; pick; select
挑选	tiāo xuǎn	pick; choose; select; pick out
调皮	tiáopí	naughty
挑	tiǎo	lift up; raise; prick; incite
挑战	tiǎozhàn	dekaron
贴	tiē	stick; paste; glue; nestle up to; keep close to
停下	tíng xià	stop
挺（动）	tǐng	stand; hold out; endure; stick out
通知书	tōng zhī shū	notice
同情	tóngqíng	sympathy
童话	tónghuà	fairy tale
童年	tóng nián	childhood; babyhood
统计	tǒngjì	statistics
统一	tǒngyī	unified
痛快	tòngkuài	happy, to one's heart's content
投	tóu	throw; fling; hurl; cast; drop; put in; send; go to
投入	tóurù	put into
投诉	tóusù	complaint
投资	tóuzī	investment
透	tòu	penetrate; pass through; tell secretly; show; through
透明	tòumíng	transparent
图案	tú'àn	pattern
途中	tú zhōng	on the way to; en route
土地	tǔdì	land
推迟	tuīchí	delay
推销	tuīxiāo	promote sales
脱	tuō	take off
袜子	wàzi	socks
外汇	wài huì	foreign exchange; foreign currency
外交官	wài jiāo guān	diplomat; diplomatist
外套	wài tào	coat
弯	wān	curved; bend; turn; crooked
晚点	wǎn diǎn	late; behind schedule
万一	wànyī	in case
王	wáng	king; monarch; head; chief
网络	wǎngluò	network
网址	wǎng zhǐ	Internet site; website; URL
微笑	wēixiào	smile
微信	wēi xìn	WeChat (a Chinese social app)
围巾	wéijīn	scarf
维持	wéichí	maintain
维护	wéihù	protect
维修	wéixiū	repair
尾巴	wěiba	tail
未必	wèibì	not necessarily
未来	wèilái	future
位于	wèiyú	be located
位置	wèizhì	position
味儿	wèir	flavor; taste
喂（动）	wèi	feed
稳	wěn	steady; stable; sure; certain
稳定	wěndìng	stable
问候	wènhòu	to greet
无	wú	nothing
无法	wú fǎ	unable; incapable
无聊	wúliáo	boring
无论	wúlùn	no matter
无数	wúshù	countless
无所谓	wúsuǒwèi	cannot be designated as
无限	wú xiàn	infinite; limitless; unlimited
五颜六色	wǔ yán liù sè	colorful; multicolored
误会	wùhuì	misunderstanding
西瓜	xīguā	watermelon
吸	xī	inhale; breathe; absorb; suck in
吸管	xī guǎn	straw
吸收	xīshōu	absorb
吸烟	xī yān	smoke
吸引	xīyǐn	attract
喜爱	xǐ ài	like; love; be fond of
系列	xìliè	series
系统	xìtǒng	system
细	xì	thin; slender; delicate; careful; trifling
细节	xìjié	details
细致	xìzhì	careful
下个月	xià gè yuè	next month
下降	xià jiàng	decline; drop; decrease; fall; go down
下楼	xià lóu	go downstairs; come downstairs
下载	xiàzài	download
夏季	xià jì	summer
鲜	xiān	fresh; bright; delicious; little; rare
鲜花	xiān huā	fresh flower
鲜明	xiānmíng	distinct
咸	xián	salty
显著	xiǎnzhù	remarkable
县	xiàn	county
限制	xiànzhì	limit
相处	xiāngchǔ	get along with
相反	xiāngfǎn	contrary
箱	xiāng	chest; box; case; trunk
箱子	xiāng zi	chest; bin; box; case; trunk
想念	xiǎngniàn	miss
想象	xiǎngxiàng	imagine
项	xiàng	term
项目	xiàngmù	project
相片	xiàng piàn	photo; photograph
消化	xiāohuà	digestion
销售	xiāoshòu	sale
小吃	xiǎochī	snack
小伙子	xiǎohuǒzi	young fellow
小型	xiǎo xíng	small-size; small-scale
效率	xiàolǜ	efficiency
些	xiē	some
心理	xīnlǐ	psychology
新郎	xīnláng	groom
新娘	xīnniáng	bride
新鲜	xīnxiān	fresh
新型	xīn xíng	new type; new kind
兴奋	xīngfèn	excitement
形容	xíngróng	describe
形势	xíngshì	situation
型	xíng	mould; model; type; pattern
型号	xíng hào	model; type; pattern
醒	xǐng	wake up
兴趣	xìng qù	interest
性质	xìngzhì	nature
兄弟	xiōngdì	brother
胸部	xiōng bù	chest; thorax; breast
修理	xiūlǐ	repair
选择	xuǎnzé	choice
学分	xué fēn	credit; academic credit
学年	xué nián	school year; academic year
学时	xué shí	class hour; period
学术	xuéshù	learning
学问	xuéwen	knowledge
寻找	xúnzhǎo	seek, look for
迅速	xùnsù	rapid
牙	yá	tooth; ivory; tooth-like thing
牙刷	yá shuā	toothbrush
亚运会	yà yùn huì	Asian Games
呀	ya	ah
延长	yáncháng	extend
延期	yánqī	delay
延续	yánxù	continue
严	yán	strict; tight; severe; stern
严格	yángé	strict
严重	yánzhòng	serious
研究	yánjiū	research
研究生	yán jiū shēng	postgraduate; graduate student
研制	yán zhì	prepare; manufacture; develop
盐	yán	salt
眼镜	yǎnjìng	glasses
眼泪	yǎn lèi	tear; eyedrop
眼里	yǎn lǐ	within one's vision; in one's eyes
演讲	yǎnjiǎng	speech
阳台	yángtái	balcony
养成	yǎngchéng	cultivate
腰	yāo	waist
摇	yáo	shake
药物	yào wù	drug; medicine
要（连）	yào	if
业余	yèyú	amateur
叶子	yèzi	leaf
医疗	yī liáo	medical treatment
医学	yī xué	medical science; medicine
依靠	yīkào	rely on; depend on
依然	yīrán	still
一律	yílǜ	all and singular
一再	yízài	repeatedly
一致	yízhì	agreement
移	yí	move; remove; shift; change; alter
移动	yídòng	move
移民	yímín	immigrant
遗产	yíchǎn	heritage
遗传	yíchuán	inheritance
疑问	yíwèn	doubt
以及	yǐjí	as well as
以内	yǐ nèi	within
一般来说	yì bān lái shuō	generally speaking
义务	yìwù	obligation
议论	yìlùn	discussion
引	yǐn	lead; guide; draw; stretch; lure; attract; cause
引导	yǐndǎo	guide
引进	yǐn jìn	introduce from elsewhere; bring in; recommend
引起	yǐnqǐ	cause
应	yīng	should; ought to; answer; respond; promise
英勇	yīngyǒng	heroic
营业	yíngyè	do business
赢得	yíng dé	gain; win
影子	yǐngzi	shadow
勇敢	yǒnggǎn	brave
勇气	yǒngqì	courage
用途	yòngtú	purpose
优良	yōu liáng	fine; good; excellent
优美	yōuměi	graceful
优秀	yōuxiù	excellent
邮局	yóujú	post office
有劲儿	yǒu jìnr	strong; energetic
有趣	yǒuqù	interesting
有限	yǒu xiàn	limited; finite
幼儿园	yòu'éryuán	kindergarten
于是	yúshì	therefore
语法	yǔfǎ	grammar
语音	yǔ yīn	voice
玉	yù	jade
玉米	yùmǐ	corn
预测	yù cè	forecast; prognosis
预订	yùdìng	book; subscribe for
遇	yù	meet; encounter
遇到	yùdào	encounter
遇见	yù jiàn	meet; come across
原料	yuánliào	raw material
原则	yuánzé	principle
圆	yuán	circular
圆满	yuánmǎn	satisfactorily
约会	yuēhuì	date
月底	yuè dǐ	the end of a month
阅读	yuèdú	read
运动会	yùn dòng huì	sports meeting
运动员	yùn dòng yuán	athlete; sportsman
运气	yùnqi	luck
运用	yùnyòng	application
再三	zàisān	repeatedly
在乎	zàihu	care about
在于	zàiyú	rest with
赞成	zànchéng	agree
赞赏	zàn shǎng	praise; panegyrize; eulogize; admiration
赞助	zànzhù	sponsor
造型	zàoxíng	style; modeling
战斗	zhàndòu	battle
战胜	zhàn shèng	defeat; conquer
战士	zhàn shì	warrior; soldier; fighter
战争	zhànzhēng	war
丈夫	zhàngfu	husband
招呼	zhāo hu	call; hail; greet; glad-hand
着	zhe	in process of
着火	zháohuǒ	on fire
着急	zháojí	worry
召开	zhàokāi	convene
折	zhé	fracture
针	zhēn	needle; injection
针对	zhēnduì	in the light of
阵	zhèn	front
争论	zhēnglùn	debate
征服	zhēngfú	conquer
征求	zhēngqiú	seek, ask for
政府	zhèngfǔ	government
政治	zhèngzhì	politics
之后	zhī hòu	later; after; afterwards
之间	zhī jiān	between; among
之前	zhī qián	before; prior to
之一	zhī yī	one of
支（动）	zhī	put up; protrude; support; send away
植物	zhíwù	botany
指挥	zhǐhuī	command
制订	zhì dìng	formulate; work out; map out
质量	zhìliàng	quality
治	zhì	rule; govern; manage; cure; treatment
治疗	zhìliáo	treatment
智力	zhìlì	intelligence
智能	zhìnéng	intelligence
中介	zhōngjiè	intermediary
种类	zhǒnglèi	type
中奖	zhòng jiǎng	win a lottery
种	zhǒng	species
种植	zhòngzhí	plant
重量	zhòngliàng	weight
逐步	zhúbù	gradually
逐渐	zhújiàn	gradually
主题	zhǔtí	theme
主席	zhǔxí	chairman
祝福	zhùfú	blessing
著名	zhùmíng	famous
著作	zhùzuò	work
抓紧	zhuājǐn	pay close attention to; grasp
专心	zhuānxīn	attentively
转动	zhuǎn dòng	turn; move; turn round
转告	zhuǎngào	tell
转身	zhuǎn shēn	turn round; face about
转弯	zhuǎn wān	make a turn; turn a corner
转移	zhuǎnyí	transfer
装修	zhuāngxiū	decorate house
装置	zhuāng zhì	device; equipment
追求	zhuīqiú	pursuit
准时	zhǔnshí	on time
资料	zīliào	data
资源	zīyuán	resources
自	zì	from; since; self; oneself
自信	zìxìn	self-confidence
字母	zìmǔ	letter
综合	zōnghé	comprehensive
总共	zǒnggòng	in total
总理	zǒnglǐ	prime minister
总统	zǒngtǒng	president
总之	zǒngzhī	in short
阻止	zǔzhǐ	prevent
嘴巴	zuǐ ba	mouth
最初	zuìchū	first
作出	zuò chū	make (a decision, etc.)
作为	zuòwéi	as
做梦	zuò mèng	dream; daydream